filename	family	variant
ABeeZee-Italic	ABeeZee	italic
ABeeZee-Regular	ABeeZee	regular
ADLaMDisplay-Regular	ADLaM Display	regular
AROneSans[ARRR,wght]	AR One Sans	regular
Abel-Regular	Abel	regular
AbhayaLibre-Bold	Abhaya Libre	bold
AbhayaLibre-ExtraBold	Abhaya Libre	extrabold
AbhayaLibre-Medium	Abhaya Libre	medium
AbhayaLibre-Regular	Abhaya Libre	regular
AbhayaLibre-SemiBold	Abhaya Libre	semibold
Aboreto-Regular	Aboreto	regular
AbrilFatface-Regular	Abril Fatface	regular
AbyssinicaSIL-Regular	Abyssinica SIL	regular
Aclonica-Regular	Aclonica	regular
Acme-Regular	Acme	regular
Actor-Regular	Actor	regular
Adamina-Regular	Adamina	regular
AdobeBlank-Regular	NONE	regular
AdventPro-Italic[wdth,wght]	Advent Pro	italic
AdventPro[wdth,wght]	Advent Pro	regular
Afacad-Italic[wght]	Afacad	italic
Afacad[wght]	Afacad	regular
Agbalumo-Regular	Agbalumo	regular
Agdasima-Bold	Agdasima	bold
Agdasima-Regular	Agdasima	regular
AguafinaScript-Regular	Aguafina Script	regular
Akatab-Black	Akatab	black
Akatab-Bold	Akatab	bold
Akatab-ExtraBold	Akatab	extrabold
Akatab-Medium	Akatab	medium
Akatab-Regular	Akatab	regular
Akatab-SemiBold	Akatab	semibold
AkayaKanadaka-Regular	Akaya Kanadaka	regular
AkayaTelivigala-Regular	Akaya Telivigala	regular
Akronim-Regular	Akronim	regular
AksaraBaliGalang-Regular	NONE	regular
Akshar[wght]	Akshar	regular
Aladin-Regular	Aladin	regular
Alata-Regular	Alata	regular
Alatsi-Regular	Alatsi	regular
AlbertSans-Italic[wght]	Albert Sans	italic
AlbertSans[wght]	Albert Sans	regular
Aldrich-Regular	Aldrich	regular
Alef-Bold	Alef	bold
Alef-Regular	Alef	regular
Alegreya-Italic[wght]	Alegreya	italic
AlegreyaSC-Black	Alegreya SC	black
AlegreyaSC-BlackItalic	Alegreya SC	blackitalic
AlegreyaSC-Bold	Alegreya SC	bold
AlegreyaSC-BoldItalic	Alegreya SC	bolditalic
AlegreyaSC-ExtraBold	Alegreya SC	extrabold
AlegreyaSC-ExtraBoldItalic	Alegreya SC	extrabolditalic
AlegreyaSC-Italic	Alegreya SC	italic
AlegreyaSC-Medium	Alegreya SC	medium
AlegreyaSC-MediumItalic	Alegreya SC	mediumitalic
AlegreyaSC-Regular	Alegreya SC	regular
AlegreyaSans-Black	Alegreya Sans	black
AlegreyaSans-BlackItalic	Alegreya Sans	blackitalic
AlegreyaSans-Bold	Alegreya Sans	bold
AlegreyaSans-BoldItalic	Alegreya Sans	bolditalic
AlegreyaSans-ExtraBold	Alegreya Sans	extrabold
AlegreyaSans-ExtraBoldItalic	Alegreya Sans	extrabolditalic
AlegreyaSans-Italic	Alegreya Sans	italic
AlegreyaSans-Light	Alegreya Sans	light
AlegreyaSans-LightItalic	Alegreya Sans	lightitalic
AlegreyaSans-Medium	Alegreya Sans	medium
AlegreyaSans-MediumItalic	Alegreya Sans	mediumitalic
AlegreyaSans-Regular	Alegreya Sans	regular
AlegreyaSans-Thin	Alegreya Sans	thin
AlegreyaSans-ThinItalic	Alegreya Sans	thinitalic
AlegreyaSansSC-Black	Alegreya Sans SC	black
AlegreyaSansSC-BlackItalic	Alegreya Sans SC	blackitalic
AlegreyaSansSC-Bold	Alegreya Sans SC	bold
AlegreyaSansSC-BoldItalic	Alegreya Sans SC	bolditalic
AlegreyaSansSC-ExtraBold	Alegreya Sans SC	extrabold
AlegreyaSansSC-ExtraBoldItalic	Alegreya Sans SC	extrabolditalic
AlegreyaSansSC-Italic	Alegreya Sans SC	italic
AlegreyaSansSC-Light	Alegreya Sans SC	light
AlegreyaSansSC-LightItalic	Alegreya Sans SC	lightitalic
AlegreyaSansSC-Medium	Alegreya Sans SC	medium
AlegreyaSansSC-MediumItalic	Alegreya Sans SC	mediumitalic
AlegreyaSansSC-Regular	Alegreya Sans SC	regular
AlegreyaSansSC-Thin	Alegreya Sans SC	thin
AlegreyaSansSC-ThinItalic	Alegreya Sans SC	thinitalic
Alegreya[wght]	Alegreya	regular
Aleo-Italic[wght]	Aleo	italic
Aleo[wght]	Aleo	regular
AlexBrush-Regular	Alex Brush	regular
Alexandria[wght]	Alexandria	regular
AlfaSlabOne-Regular	Alfa Slab One	regular
Alice-Regular	Alice	regular
Alike-Regular	Alike	regular
AlikeAngular-Regular	Alike Angular	regular
Alkalami-Regular	Alkalami	regular
Alkatra[wght]	Alkatra	regular
Allan-Bold	Allan	bold
Allan-Regular	Allan	regular
Allerta-Regular	Allerta	regular
AllertaStencil-Regular	Allerta Stencil	regular
Allison-Regular	Allison	regular
Allura-Regular	Allura	regular
Almarai-Bold	Almarai	bold
Almarai-ExtraBold	Almarai	extrabold
Almarai-Light	Almarai	light
Almarai-Regular	Almarai	regular
Almendra-Bold	Almendra	bold
Almendra-BoldItalic	Almendra	bolditalic
Almendra-Italic	Almendra	italic
Almendra-Regular	Almendra	regular
AlmendraDisplay-Regular	Almendra Display	regular
AlmendraSC-Regular	Almendra SC	regular
AlumniSans-Italic[wght]	Alumni Sans	italic
AlumniSansCollegiateOne-Italic	Alumni Sans Collegiate One	italic
AlumniSansCollegiateOne-Regular	Alumni Sans Collegiate One	regular
AlumniSansInlineOne-Italic	Alumni Sans Inline One	italic
AlumniSansInlineOne-Regular	Alumni Sans Inline One	regular
AlumniSansPinstripe-Italic	Alumni Sans Pinstripe	italic
AlumniSansPinstripe-Regular	Alumni Sans Pinstripe	regular
AlumniSans[wght]	Alumni Sans	regular
Amarante-Regular	Amarante	regular
Amaranth-Bold	Amaranth	bold
Amaranth-BoldItalic	Amaranth	bolditalic
Amaranth-Italic	Amaranth	italic
Amaranth-Regular	Amaranth	regular
AmaticSC-Bold	Amatic SC	bold
AmaticSC-Regular	Amatic SC	regular
Amethysta-Regular	Amethysta	regular
Amiko-Bold	Amiko	bold
Amiko-Regular	Amiko	regular
Amiko-SemiBold	Amiko	semibold
Amiri-Bold	Amiri	bold
Amiri-BoldItalic	Amiri	bolditalic
Amiri-Italic	Amiri	italic
Amiri-Regular	Amiri	regular
AmiriQuran-Regular	Amiri Quran	regular
Amita-Bold	Amita	bold
Amita-Regular	Amita	regular
AmstelvarAlpha-VF	NONE	vf
Anaheim-Regular	Anaheim	regular
AndadaPro-Italic[wght]	Andada Pro	italic
AndadaPro[wght]	Andada Pro	regular
Andika-Bold	Andika	bold
Andika-BoldItalic	Andika	bolditalic
Andika-Italic	Andika	italic
Andika-Regular	Andika	regular
AnekBangla[wdth,wght]	Anek Bangla	regular
AnekDevanagari[wdth,wght]	Anek Devanagari	regular
AnekGujarati[wdth,wght]	Anek Gujarati	regular
AnekGurmukhi[wdth,wght]	Anek Gurmukhi	regular
AnekKannada[wdth,wght]	Anek Kannada	regular
AnekLatin[wdth,wght]	Anek Latin	regular
AnekMalayalam[wdth,wght]	Anek Malayalam	regular
AnekOdia[wdth,wght]	Anek Odia	regular
AnekTamil[wdth,wght]	Anek Tamil	regular
AnekTelugu[wdth,wght]	Anek Telugu	regular
Angkor-Regular	Angkor	regular
AnnieUseYourTelescope-Regular	Annie Use Your Telescope	regular
AnonymousPro-Bold	Anonymous Pro	bold
AnonymousPro-BoldItalic	Anonymous Pro	bolditalic
AnonymousPro-Italic	Anonymous Pro	italic
AnonymousPro-Regular	Anonymous Pro	regular
Antic-Regular	Antic	regular
AnticDidone-Regular	Antic Didone	regular
AnticSlab-Regular	Antic Slab	regular
Anton-Regular	Anton	regular
Antonio[wght]	Antonio	regular
Anuphan[wght]	Anuphan	regular
Anybody-Italic[wdth,wght]	Anybody	italic
Anybody[wdth,wght]	Anybody	regular
AoboshiOne-Regular	Aoboshi One	regular
Arapey-Italic	Arapey	italic
Arapey-Regular	Arapey	regular
Arbutus-Regular	Arbutus	regular
ArbutusSlab-Regular	Arbutus Slab	regular
ArchitectsDaughter-Regular	Architects Daughter	regular
Archivo-Italic[wdth,wght]	Archivo	italic
ArchivoBlack-Regular	Archivo Black	regular
ArchivoNarrow-Italic[wght]	Archivo Narrow	italic
ArchivoNarrow[wght]	Archivo Narrow	regular
Archivo[wdth,wght]	Archivo	regular
AreYouSerious-Regular	Are You Serious	regular
ArefRuqaa-Bold	Aref Ruqaa	bold
ArefRuqaa-Regular	Aref Ruqaa	regular
ArefRuqaaInk-Bold	Aref Ruqaa Ink	bold
ArefRuqaaInk-Regular	Aref Ruqaa Ink	regular
Arial Black	NONE	regular
Arial Narrow	NONE	regular
Arial	NONE	regular
Arima[wght]	Arima	regular
Arimo-Italic[wght]	Arimo	italic
Arimo[wght]	Arimo	regular
Arizonia-Regular	Arizonia	regular
Armata-Regular	Armata	regular
Arsenal-Bold	Arsenal	bold
Arsenal-BoldItalic	Arsenal	bolditalic
Arsenal-Italic	Arsenal	italic
Arsenal-Regular	Arsenal	regular
Artifika-Regular	Artifika	regular
Arvo-Bold	Arvo	bold
Arvo-BoldItalic	Arvo	bolditalic
Arvo-Italic	Arvo	italic
Arvo-Regular	Arvo	regular
Arya-Bold	Arya	bold
Arya-Regular	Arya	regular
Asap-Italic[wdth,wght]	Asap	italic
AsapCondensed-Black	Asap Condensed	black
AsapCondensed-BlackItalic	Asap Condensed	blackitalic
AsapCondensed-Bold	Asap Condensed	bold
AsapCondensed-BoldItalic	Asap Condensed	bolditalic
AsapCondensed-ExtraBold	Asap Condensed	extrabold
AsapCondensed-ExtraBoldItalic	Asap Condensed	extrabolditalic
AsapCondensed-ExtraLight	Asap Condensed	extralight
AsapCondensed-ExtraLightItalic	Asap Condensed	extralightitalic
AsapCondensed-Italic	Asap Condensed	italic
AsapCondensed-Light	Asap Condensed	light
AsapCondensed-LightItalic	Asap Condensed	lightitalic
AsapCondensed-Medium	Asap Condensed	medium
AsapCondensed-MediumItalic	Asap Condensed	mediumitalic
AsapCondensed-Regular	Asap Condensed	regular
AsapCondensed-SemiBold	Asap Condensed	semibold
AsapCondensed-SemiBoldItalic	Asap Condensed	semibolditalic
Asap[wdth,wght]	Asap	regular
Asar-Regular	Asar	regular
Asset-Regular	Asset	regular
Assistant[wght]	Assistant	regular
Astloch-Bold	Astloch	bold
Astloch-Regular	Astloch	regular
Asul-Bold	Asul	bold
Asul-Regular	Asul	regular
Athiti-Bold	Athiti	bold
Athiti-ExtraLight	Athiti	extralight
Athiti-Light	Athiti	light
Athiti-Medium	Athiti	medium
Athiti-Regular	Athiti	regular
Athiti-SemiBold	Athiti	semibold
AtkinsonHyperlegible-Bold	Atkinson Hyperlegible	bold
AtkinsonHyperlegible-BoldItalic	Atkinson Hyperlegible	bolditalic
AtkinsonHyperlegible-Italic	Atkinson Hyperlegible	italic
AtkinsonHyperlegible-Regular	Atkinson Hyperlegible	regular
Atma-Bold	Atma	bold
Atma-Light	Atma	light
Atma-Medium	Atma	medium
Atma-Regular	Atma	regular
Atma-SemiBold	Atma	semibold
AtomicAge-Regular	Atomic Age	regular
Aubrey-Regular	Aubrey	regular
Audiowide-Regular	Audiowide	regular
AutourOne-Regular	Autour One	regular
Average-Regular	Average	regular
AverageSans-Regular	Average Sans	regular
AveriaGruesaLibre-Regular	Averia Gruesa Libre	regular
AveriaLibre-Bold	Averia Libre	bold
AveriaLibre-BoldItalic	Averia Libre	bolditalic
AveriaLibre-Italic	Averia Libre	italic
AveriaLibre-Light	Averia Libre	light
AveriaLibre-LightItalic	Averia Libre	lightitalic
AveriaLibre-Regular	Averia Libre	regular
AveriaSansLibre-Bold	Averia Sans Libre	bold
AveriaSansLibre-BoldItalic	Averia Sans Libre	bolditalic
AveriaSansLibre-Italic	Averia Sans Libre	italic
AveriaSansLibre-Light	Averia Sans Libre	light
AveriaSansLibre-LightItalic	Averia Sans Libre	lightitalic
AveriaSansLibre-Regular	Averia Sans Libre	regular
AveriaSerifLibre-Bold	Averia Serif Libre	bold
AveriaSerifLibre-BoldItalic	Averia Serif Libre	bolditalic
AveriaSerifLibre-Italic	Averia Serif Libre	italic
AveriaSerifLibre-Light	Averia Serif Libre	light
AveriaSerifLibre-LightItalic	Averia Serif Libre	lightitalic
AveriaSerifLibre-Regular	Averia Serif Libre	regular
AzeretMono-Italic[wght]	Azeret Mono	italic
AzeretMono[wght]	Azeret Mono	regular
B612-Bold	B612	bold
B612-BoldItalic	B612	bolditalic
B612-Italic	B612	italic
B612-Regular	B612	regular
B612Mono-Bold	B612 Mono	bold
B612Mono-BoldItalic	B612 Mono	bolditalic
B612Mono-Italic	B612 Mono	italic
B612Mono-Regular	B612 Mono	regular
BIZUDGothic-Bold	NONE	bold
BIZUDGothic-Regular	NONE	regular
BIZUDMincho-Bold	NONE	bold
BIZUDMincho-Regular	NONE	regular
BIZUDPGothic-Bold	NONE	bold
BIZUDPGothic-Regular	NONE	regular
BIZUDPMincho-Bold	NONE	bold
BIZUDPMincho-Regular	NONE	regular
BM-HANNA	NONE	NONE
Babylonica-Regular	Babylonica	regular
BacasimeAntique-Regular	Bacasime Antique	regular
BadScript-Regular	Bad Script	regular
BagelFatOne-Regular	Bagel Fat One	regular
Bahiana-Regular	Bahiana	regular
Bahianita-Regular	Bahianita	regular
BaiJamjuree-Bold	Bai Jamjuree	bold
BaiJamjuree-BoldItalic	Bai Jamjuree	bolditalic
BaiJamjuree-ExtraLight	Bai Jamjuree	extralight
BaiJamjuree-ExtraLightItalic	Bai Jamjuree	extralightitalic
BaiJamjuree-Italic	Bai Jamjuree	italic
BaiJamjuree-Light	Bai Jamjuree	light
BaiJamjuree-LightItalic	Bai Jamjuree	lightitalic
BaiJamjuree-Medium	Bai Jamjuree	medium
BaiJamjuree-MediumItalic	Bai Jamjuree	mediumitalic
BaiJamjuree-Regular	Bai Jamjuree	regular
BaiJamjuree-SemiBold	Bai Jamjuree	semibold
BaiJamjuree-SemiBoldItalic	Bai Jamjuree	semibolditalic
BakbakOne-Regular	Bakbak One	regular
Ballet[opsz]	Ballet	regular
Baloo2[wght]	Baloo 2	regular
BalooBhai2[wght]	Baloo Bhai 2	regular
BalooBhaijaan2[wght]	Baloo Bhaijaan 2	regular
BalooBhaina2[wght]	Baloo Bhaina 2	regular
BalooChettan2[wght]	Baloo Chettan 2	regular
BalooDa2[wght]	Baloo Da 2	regular
BalooPaaji2[wght]	Baloo Paaji 2	regular
BalooTamma2[wght]	Baloo Tamma 2	regular
BalooTammudu2[wght]	Baloo Tammudu 2	regular
BalooThambi2[wght]	Baloo Thambi 2	regular
BalsamiqSans-Bold	Balsamiq Sans	bold
BalsamiqSans-BoldItalic	Balsamiq Sans	bolditalic
BalsamiqSans-Italic	Balsamiq Sans	italic
BalsamiqSans-Regular	Balsamiq Sans	regular
Balthazar-Regular	Balthazar	regular
Bangers-Regular	Bangers	regular
Barlow-Black	Barlow	black
Barlow-BlackItalic	Barlow	blackitalic
Barlow-Bold	Barlow	bold
Barlow-BoldItalic	Barlow	bolditalic
Barlow-ExtraBold	Barlow	extrabold
Barlow-ExtraBoldItalic	Barlow	extrabolditalic
Barlow-ExtraLight	Barlow	extralight
Barlow-ExtraLightItalic	Barlow	extralightitalic
Barlow-Italic	Barlow	italic
Barlow-Light	Barlow	light
Barlow-LightItalic	Barlow	lightitalic
Barlow-Medium	Barlow	medium
Barlow-MediumItalic	Barlow	mediumitalic
Barlow-Regular	Barlow	regular
Barlow-SemiBold	Barlow	semibold
Barlow-SemiBoldItalic	Barlow	semibolditalic
Barlow-Thin	Barlow	thin
Barlow-ThinItalic	Barlow	thinitalic
BarlowCondensed-Black	Barlow Condensed	black
BarlowCondensed-BlackItalic	Barlow Condensed	blackitalic
BarlowCondensed-Bold	Barlow Condensed	bold
BarlowCondensed-BoldItalic	Barlow Condensed	bolditalic
BarlowCondensed-ExtraBold	Barlow Condensed	extrabold
BarlowCondensed-ExtraBoldItalic	Barlow Condensed	extrabolditalic
BarlowCondensed-ExtraLight	Barlow Condensed	extralight
BarlowCondensed-ExtraLightItalic	Barlow Condensed	extralightitalic
BarlowCondensed-Italic	Barlow Condensed	italic
BarlowCondensed-Light	Barlow Condensed	light
BarlowCondensed-LightItalic	Barlow Condensed	lightitalic
BarlowCondensed-Medium	Barlow Condensed	medium
BarlowCondensed-MediumItalic	Barlow Condensed	mediumitalic
BarlowCondensed-Regular	Barlow Condensed	regular
BarlowCondensed-SemiBold	Barlow Condensed	semibold
BarlowCondensed-SemiBoldItalic	Barlow Condensed	semibolditalic
BarlowCondensed-Thin	Barlow Condensed	thin
BarlowCondensed-ThinItalic	Barlow Condensed	thinitalic
BarlowSemiCondensed-Black	Barlow Semi Condensed	black
BarlowSemiCondensed-BlackItalic	Barlow Semi Condensed	blackitalic
BarlowSemiCondensed-Bold	Barlow Semi Condensed	bold
BarlowSemiCondensed-BoldItalic	Barlow Semi Condensed	bolditalic
BarlowSemiCondensed-ExtraBold	Barlow Semi Condensed	extrabold
BarlowSemiCondensed-ExtraBoldItalic	Barlow Semi Condensed	extrabolditalic
BarlowSemiCondensed-ExtraLight	Barlow Semi Condensed	extralight
BarlowSemiCondensed-ExtraLightItalic	Barlow Semi Condensed	extralightitalic
BarlowSemiCondensed-Italic	Barlow Semi Condensed	italic
BarlowSemiCondensed-Light	Barlow Semi Condensed	light
BarlowSemiCondensed-LightItalic	Barlow Semi Condensed	lightitalic
BarlowSemiCondensed-Medium	Barlow Semi Condensed	medium
BarlowSemiCondensed-MediumItalic	Barlow Semi Condensed	mediumitalic
BarlowSemiCondensed-Regular	Barlow Semi Condensed	regular
BarlowSemiCondensed-SemiBold	Barlow Semi Condensed	semibold
BarlowSemiCondensed-SemiBoldItalic	Barlow Semi Condensed	semibolditalic
BarlowSemiCondensed-Thin	Barlow Semi Condensed	thin
BarlowSemiCondensed-ThinItalic	Barlow Semi Condensed	thinitalic
Barriecito-Regular	Barriecito	regular
Barrio-Regular	Barrio	regular
Basic-Regular	Basic	regular
Baskervville-Italic	Baskervville	italic
Baskervville-Regular	Baskervville	regular
Battambang-Black	Battambang	black
Battambang-Bold	Battambang	bold
Battambang-Light	Battambang	light
Battambang-Regular	Battambang	regular
Battambang-Thin	Battambang	thin
Baumans-Regular	Baumans	regular
Bayon-Regular	Bayon	regular
BeVietnamPro-Black	Be Vietnam Pro	black
BeVietnamPro-BlackItalic	Be Vietnam Pro	blackitalic
BeVietnamPro-Bold	Be Vietnam Pro	bold
BeVietnamPro-BoldItalic	Be Vietnam Pro	bolditalic
BeVietnamPro-ExtraBold	Be Vietnam Pro	extrabold
BeVietnamPro-ExtraBoldItalic	Be Vietnam Pro	extrabolditalic
BeVietnamPro-ExtraLight	Be Vietnam Pro	extralight
BeVietnamPro-ExtraLightItalic	Be Vietnam Pro	extralightitalic
BeVietnamPro-Italic	Be Vietnam Pro	italic
BeVietnamPro-Light	Be Vietnam Pro	light
BeVietnamPro-LightItalic	Be Vietnam Pro	lightitalic
BeVietnamPro-Medium	Be Vietnam Pro	medium
BeVietnamPro-MediumItalic	Be Vietnam Pro	mediumitalic
BeVietnamPro-Regular	Be Vietnam Pro	regular
BeVietnamPro-SemiBold	Be Vietnam Pro	semibold
BeVietnamPro-SemiBoldItalic	Be Vietnam Pro	semibolditalic
BeVietnamPro-Thin	Be Vietnam Pro	thin
BeVietnamPro-ThinItalic	Be Vietnam Pro	thinitalic
BeauRivage-Regular	Beau Rivage	regular
BebasNeue-Regular	Bebas Neue	regular
Belanosima-Bold	Belanosima	bold
Belanosima-Regular	Belanosima	regular
Belanosima-SemiBold	Belanosima	semibold
Belgrano-Regular	Belgrano	regular
Bellefair-Regular	Bellefair	regular
Belleza-Regular	Belleza	regular
Bellota-Bold	Bellota	bold
Bellota-BoldItalic	Bellota	bolditalic
Bellota-Italic	Bellota	italic
Bellota-Light	Bellota	light
Bellota-LightItalic	Bellota	lightitalic
Bellota-Regular	Bellota	regular
BellotaText-Bold	Bellota Text	bold
BellotaText-BoldItalic	Bellota Text	bolditalic
BellotaText-Italic	Bellota Text	italic
BellotaText-Light	Bellota Text	light
BellotaText-LightItalic	Bellota Text	lightitalic
BellotaText-Regular	Bellota Text	regular
BenchNine-Bold	NONE	bold
BenchNine-Light	NONE	light
BenchNine-Regular	NONE	regular
Benne-Regular	Benne	regular
Bentham-Regular	Bentham	regular
BerkshireSwash-Regular	Berkshire Swash	regular
Besley-Italic[wght]	Besley	italic
Besley[wght]	Besley	regular
BethEllen-Regular	Beth Ellen	regular
Bevan-Italic	Bevan	italic
Bevan-Regular	Bevan	regular
Bhavuka-Regular	NONE	regular
BhuTukaExpandedOne-Regular	BhuTuka Expanded One	regular
BigShouldersDisplay[wght]	Big Shoulders Display	regular
BigShouldersInlineDisplay[wght]	Big Shoulders Inline Display	regular
BigShouldersInlineText[wght]	Big Shoulders Inline Text	regular
BigShouldersStencilDisplay[wght]	Big Shoulders Stencil Display	regular
BigShouldersStencilText[wght]	Big Shoulders Stencil Text	regular
BigShouldersText[wght]	Big Shoulders Text	regular
BigelowRules-Regular	Bigelow Rules	regular
BigshotOne-Regular	Bigshot One	regular
Bilbo-Regular	Bilbo	regular
BilboSwashCaps-Regular	Bilbo Swash Caps	regular
BioRhymeExpanded-Bold	BioRhyme Expanded	bold
BioRhymeExpanded-ExtraBold	BioRhyme Expanded	extrabold
BioRhymeExpanded-ExtraLight	BioRhyme Expanded	extralight
BioRhymeExpanded-Light	BioRhyme Expanded	light
BioRhymeExpanded-Regular	BioRhyme Expanded	regular
BioRhyme[wdth,wght]	BioRhyme	regular
Birthstone-Regular	Birthstone	regular
BirthstoneBounce-Medium	Birthstone Bounce	medium
BirthstoneBounce-Regular	Birthstone Bounce	regular
Biryani-Black	Biryani	black
Biryani-Bold	Biryani	bold
Biryani-ExtraBold	Biryani	extrabold
Biryani-ExtraLight	Biryani	extralight
Biryani-Light	Biryani	light
Biryani-Regular	Biryani	regular
Biryani-SemiBold	Biryani	semibold
Bitter-Italic[wght]	Bitter	italic
Bitter[wght]	Bitter	regular
BlackAndWhitePicture-Regular	Black And White Picture	regular
BlackHanSans-Regular	Black Han Sans	regular
BlackOpsOne-Regular	Black Ops One	regular
Blaka-Regular	Blaka	regular
BlakaHollow-Regular	Blaka Hollow	regular
BlakaInk-Regular	Blaka Ink	regular
Blinker-Black	Blinker	black
Blinker-Bold	Blinker	bold
Blinker-ExtraBold	Blinker	extrabold
Blinker-ExtraLight	Blinker	extralight
Blinker-Light	Blinker	light
Blinker-Regular	Blinker	regular
Blinker-SemiBold	Blinker	semibold
Blinker-Thin	Blinker	thin
BodoniModa-Italic[opsz,wght]	Bodoni Moda	italic
BodoniModa[opsz,wght]	Bodoni Moda	regular
Bokor-Regular	Bokor	regular
BonaNova-Bold	Bona Nova	bold
BonaNova-Italic	Bona Nova	italic
BonaNova-Regular	Bona Nova	regular
Bonbon-Regular	Bonbon	regular
BonheurRoyale-Regular	Bonheur Royale	regular
Boogaloo-Regular	Boogaloo	regular
Borel-Regular	Borel	regular
BowlbyOne-Regular	Bowlby One	regular
BowlbyOneSC-Regular	Bowlby One SC	regular
BraahOne-Regular	Braah One	regular
Brawler-Bold	Brawler	bold
Brawler-Regular	Brawler	regular
BreeSerif-Regular	Bree Serif	regular
BricolageGrotesque[opsz,wdth,wght]	Bricolage Grotesque	regular
BrunoAce-Regular	Bruno Ace	regular
BrunoAceSC-Regular	Bruno Ace SC	regular
Brygada1918-Italic[wght]	Brygada 1918	italic
Brygada1918[wght]	Brygada 1918	regular
BubblegumSans-Regular	Bubblegum Sans	regular
BubblerOne-Regular	Bubbler One	regular
Buda-Light	Buda	light
Buenard-Bold	Buenard	bold
Buenard-Regular	Buenard	regular
Bungee-Regular	Bungee	regular
BungeeColor-Regular	NONE	regular
BungeeHairline-Regular	Bungee Hairline	regular
BungeeInline-Regular	Bungee Inline	regular
BungeeOutline-Regular	Bungee Outline	regular
BungeeShade-Regular	Bungee Shade	regular
BungeeSpice-Regular	Bungee Spice	regular
Butcherman-Regular	Butcherman	regular
ButterflyKids-Regular	Butterfly Kids	regular
Cabin-Italic[wdth,wght]	Cabin	italic
CabinCondensed-Bold	Cabin Condensed	bold
CabinCondensed-Medium	Cabin Condensed	medium
CabinCondensed-Regular	Cabin Condensed	regular
CabinCondensed-SemiBold	Cabin Condensed	semibold
CabinSketch-Bold	Cabin Sketch	bold
CabinSketch-Regular	Cabin Sketch	regular
Cabin[wdth,wght]	Cabin	regular
CaesarDressing-Regular	Caesar Dressing	regular
Cagliostro-Regular	Cagliostro	regular
CairoPlay[slnt,wght]	Cairo Play	regular
Cairo[slnt,wght]	Cairo	regular
Caladea-Bold	Caladea	bold
Caladea-BoldItalic	Caladea	bolditalic
Caladea-Italic	Caladea	italic
Caladea-Regular	Caladea	regular
Calistoga-Regular	Calistoga	regular
Calligraffitti-Regular	Calligraffitti	regular
Cambay-Bold	Cambay	bold
Cambay-BoldItalic	Cambay	bolditalic
Cambay-Italic	Cambay	italic
Cambay-Regular	Cambay	regular
Cambo-Regular	Cambo	regular
Candal	Candal	regular
Cantarell-Bold	Cantarell	bold
Cantarell-BoldItalic	Cantarell	bolditalic
Cantarell-Italic	Cantarell	italic
Cantarell-Regular	Cantarell	regular
CantataOne-Regular	Cantata One	regular
CantoraOne-Regular	Cantora One	regular
Caprasimo-Regular	Caprasimo	regular
Capriola-Regular	Capriola	regular
Caramel-Regular	Caramel	regular
Carattere-Regular	Carattere	regular
Cardo-Bold	Cardo	bold
Cardo-Italic	Cardo	italic
Cardo-Regular	Cardo	regular
Carlito-Bold	Carlito	bold
Carlito-BoldItalic	Carlito	bolditalic
Carlito-Italic	Carlito	italic
Carlito-Regular	Carlito	regular
Carme-Regular	Carme	regular
CarroisGothic-Regular	Carrois Gothic	regular
CarroisGothicSC-Regular	Carrois Gothic SC	regular
CarterOne	Carter One	regular
Castoro-Italic	Castoro	italic
Castoro-Regular	Castoro	regular
CastoroTitling-Regular	Castoro Titling	regular
Catamaran[wght]	Catamaran	regular
Caudex-Bold	Caudex	bold
Caudex-BoldItalic	Caudex	bolditalic
Caudex-Italic	Caudex	italic
Caudex-Regular	Caudex	regular
CaveatBrush-Regular	Caveat Brush	regular
Caveat[wght]	Caveat	regular
Cedarville-Cursive	Cedarville Cursive	regular
CevicheOne-Regular	Ceviche One	regular
ChakraPetch-Bold	Chakra Petch	bold
ChakraPetch-BoldItalic	Chakra Petch	bolditalic
ChakraPetch-ExtraLight	Chakra Petch	extralight
ChakraPetch-ExtraLightItalic	Chakra Petch	extralightitalic
ChakraPetch-Italic	Chakra Petch	italic
ChakraPetch-Light	Chakra Petch	light
ChakraPetch-LightItalic	Chakra Petch	lightitalic
ChakraPetch-Medium	Chakra Petch	medium
ChakraPetch-MediumItalic	Chakra Petch	mediumitalic
ChakraPetch-Regular	Chakra Petch	regular
ChakraPetch-SemiBold	Chakra Petch	semibold
ChakraPetch-SemiBoldItalic	Chakra Petch	semibolditalic
ChangaOne-Italic	Changa One	italic
ChangaOne-Regular	Changa One	regular
Changa[wght]	Changa	regular
Chango-Regular	Chango	regular
CharisSIL-Bold	Charis SIL	bold
CharisSIL-BoldItalic	Charis SIL	bolditalic
CharisSIL-Italic	Charis SIL	italic
CharisSIL-Regular	Charis SIL	regular
Charm-Bold	Charm	bold
Charm-Regular	Charm	regular
Charmonman-Bold	Charmonman	bold
Charmonman-Regular	Charmonman	regular
Chathura-Bold	Chathura	bold
Chathura-ExtraBold	Chathura	extrabold
Chathura-Light	Chathura	light
Chathura-Regular	Chathura	regular
Chathura-Thin	Chathura	thin
ChauPhilomeneOne-Italic	Chau Philomene One	italic
ChauPhilomeneOne-Regular	Chau Philomene One	regular
ChelaOne-Regular	Chela One	regular
ChelseaMarket-Regular	Chelsea Market	regular
Chenla	Chenla	regular
Cherish-Regular	Cherish	regular
CherryBombOne-Regular	Cherry Bomb One	regular
CherryCreamSoda-Regular	Cherry Cream Soda	regular
CherrySwash-Bold	Cherry Swash	bold
CherrySwash-Regular	Cherry Swash	regular
Chewy-Regular	Chewy	regular
Chicle-Regular	Chicle	regular
Chilanka-Regular	Chilanka	regular
Chivo-Italic[wght]	Chivo	italic
ChivoMono-Italic[wght]	Chivo Mono	italic
ChivoMono[wght]	Chivo Mono	regular
Chivo[wght]	Chivo	regular
Chokokutai-Regular	Chokokutai	regular
Chonburi-Regular	Chonburi	regular
CinzelDecorative-Black	Cinzel Decorative	black
CinzelDecorative-Bold	Cinzel Decorative	bold
CinzelDecorative-Regular	Cinzel Decorative	regular
Cinzel[wght]	Cinzel	regular
ClickerScript-Regular	Clicker Script	regular
ClimateCrisis[YEAR]	Climate Crisis	regular
Coda-ExtraBold	Coda	extrabold
Coda-Regular	Coda	regular
Codystar-Light	Codystar	light
Codystar-Regular	Codystar	regular
Coiny-Regular	Coiny	regular
Combo-Regular	Combo	regular
Comfortaa[wght]	Comfortaa	regular
Comforter-Regular	Comforter	regular
ComforterBrush-Regular	Comforter Brush	regular
ComicNeue-Bold	Comic Neue	bold
ComicNeue-BoldItalic	Comic Neue	bolditalic
ComicNeue-Italic	Comic Neue	italic
ComicNeue-Light	Comic Neue	light
ComicNeue-LightItalic	Comic Neue	lightitalic
ComicNeue-Regular	Comic Neue	regular
ComingSoon-Regular	Coming Soon	regular
Comme[wght]	Comme	regular
Commissioner[FLAR,VOLM,slnt,wght]	Commissioner	regular
ConcertOne-Regular	Concert One	regular
Condiment-Regular	Condiment	regular
Content-Bold	Content	bold
Content-Regular	Content	regular
ContrailOne-Regular	Contrail One	regular
Convergence-Regular	Convergence	regular
Cookie-Regular	Cookie	regular
Copse-Regular	Copse	regular
Corben-Bold	Corben	bold
Corben-Regular	Corben	regular
Corinthia-Bold	Corinthia	bold
Corinthia-Regular	Corinthia	regular
Cormorant-Italic[wght]	Cormorant	italic
CormorantGaramond-Bold	Cormorant Garamond	bold
CormorantGaramond-BoldItalic	Cormorant Garamond	bolditalic
CormorantGaramond-Italic	Cormorant Garamond	italic
CormorantGaramond-Light	Cormorant Garamond	light
CormorantGaramond-LightItalic	Cormorant Garamond	lightitalic
CormorantGaramond-Medium	Cormorant Garamond	medium
CormorantGaramond-MediumItalic	Cormorant Garamond	mediumitalic
CormorantGaramond-Regular	Cormorant Garamond	regular
CormorantGaramond-SemiBold	Cormorant Garamond	semibold
CormorantGaramond-SemiBoldItalic	Cormorant Garamond	semibolditalic
CormorantInfant-Bold	Cormorant Infant	bold
CormorantInfant-BoldItalic	Cormorant Infant	bolditalic
CormorantInfant-Italic	Cormorant Infant	italic
CormorantInfant-Light	Cormorant Infant	light
CormorantInfant-LightItalic	Cormorant Infant	lightitalic
CormorantInfant-Medium	Cormorant Infant	medium
CormorantInfant-MediumItalic	Cormorant Infant	mediumitalic
CormorantInfant-Regular	Cormorant Infant	regular
CormorantInfant-SemiBold	Cormorant Infant	semibold
CormorantInfant-SemiBoldItalic	Cormorant Infant	semibolditalic
CormorantSC-Bold	Cormorant SC	bold
CormorantSC-Light	Cormorant SC	light
CormorantSC-Medium	Cormorant SC	medium
CormorantSC-Regular	Cormorant SC	regular
CormorantSC-SemiBold	Cormorant SC	semibold
CormorantUnicase-Bold	Cormorant Unicase	bold
CormorantUnicase-Light	Cormorant Unicase	light
CormorantUnicase-Medium	Cormorant Unicase	medium
CormorantUnicase-Regular	Cormorant Unicase	regular
CormorantUnicase-SemiBold	Cormorant Unicase	semibold
CormorantUpright-Bold	Cormorant Upright	bold
CormorantUpright-Light	Cormorant Upright	light
CormorantUpright-Medium	Cormorant Upright	medium
CormorantUpright-Regular	Cormorant Upright	regular
CormorantUpright-SemiBold	Cormorant Upright	semibold
Cormorant[wght]	Cormorant	regular
Courgette-Regular	Courgette	regular
Courier New	NONE	regular
CourierPrime-Bold	Courier Prime	bold
CourierPrime-BoldItalic	Courier Prime	bolditalic
CourierPrime-Italic	Courier Prime	italic
CourierPrime-Regular	Courier Prime	regular
Cousine-Bold	Cousine	bold
Cousine-BoldItalic	Cousine	bolditalic
Cousine-Italic	Cousine	italic
Cousine-Regular	Cousine	regular
Coustard-Black	Coustard	black
Coustard-Regular	Coustard	regular
CoveredByYourGrace	Covered By Your Grace	regular
CraftyGirls-Regular	Crafty Girls	regular
Creepster-Regular	Creepster	regular
CreepsterCaps-Regular	NONE	regular
CreteRound-Italic	Crete Round	italic
CreteRound-Regular	Crete Round	regular
CrimsonPro-Italic[wght]	Crimson Pro	italic
CrimsonPro[wght]	Crimson Pro	regular
CrimsonText-Bold	Crimson Text	bold
CrimsonText-BoldItalic	Crimson Text	bolditalic
CrimsonText-Italic	Crimson Text	italic
CrimsonText-Regular	Crimson Text	regular
CrimsonText-SemiBold	Crimson Text	semibold
CrimsonText-SemiBoldItalic	Crimson Text	semibolditalic
CroissantOne-Regular	Croissant One	regular
Crushed-Regular	Crushed	regular
Cuprum-Italic[wght]	Cuprum	italic
Cuprum[wght]	Cuprum	regular
CuteFont-Regular	Cute Font	regular
Cutive-Regular	Cutive	regular
CutiveMono-Regular	Cutive Mono	regular
DMMono-Italic	DM Mono	italic
DMMono-Light	DM Mono	light
DMMono-LightItalic	DM Mono	lightitalic
DMMono-Medium	DM Mono	medium
DMMono-MediumItalic	DM Mono	mediumitalic
DMMono-Regular	DM Mono	regular
DMSans-Italic[opsz,wght]	DM Sans	italic
DMSans[opsz,wght]	DM Sans	regular
DMSerifDisplay-Italic	DM Serif Display	italic
DMSerifDisplay-Regular	DM Serif Display	regular
DMSerifText-Italic	DM Serif Text	italic
DMSerifText-Regular	DM Serif Text	regular
DaiBannaSIL-Bold	Dai Banna SIL	bold
DaiBannaSIL-BoldItalic	Dai Banna SIL	bolditalic
DaiBannaSIL-Italic	Dai Banna SIL	italic
DaiBannaSIL-Light	Dai Banna SIL	light
DaiBannaSIL-LightItalic	Dai Banna SIL	lightitalic
DaiBannaSIL-Medium	Dai Banna SIL	medium
DaiBannaSIL-MediumItalic	Dai Banna SIL	mediumitalic
DaiBannaSIL-Regular	Dai Banna SIL	regular
DaiBannaSIL-SemiBold	Dai Banna SIL	semibold
DaiBannaSIL-SemiBoldItalic	Dai Banna SIL	semibolditalic
Damion-Regular	Damion	regular
DancingScript[wght]	Dancing Script	regular
Dangrek-Regular	Dangrek	regular
DarkerGrotesque[wght]	Darker Grotesque	regular
DarumadropOne-Regular	Darumadrop One	regular
DavidLibre-Bold	David Libre	bold
DavidLibre-Medium	David Libre	medium
DavidLibre-Regular	David Libre	regular
DawningofaNewDay	Dawning of a New Day	regular
DaysOne-Regular	Days One	regular
DecovarAlpha-VF	NONE	vf
Dekko-Regular	Dekko	regular
DelaGothicOne-Regular	Dela Gothic One	regular
DeliciousHandrawn-Regular	Delicious Handrawn	regular
Delius-Regular	Delius	regular
DeliusSwashCaps-Regular	Delius Swash Caps	regular
DeliusUnicase-Bold	Delius Unicase	bold
DeliusUnicase-Regular	Delius Unicase	regular
DellaRespira-Regular	Della Respira	regular
DenkOne-Regular	Denk One	regular
Devonshire-Regular	Devonshire	regular
Dhurjati-Regular	Dhurjati	regular
Dhyana-Bold	NONE	bold
Dhyana-Regular	NONE	regular
DidactGothic-Regular	Didact Gothic	regular
DigitalNumbers-Regular	NONE	regular
Diphylleia-Regular	Diphylleia	regular
Diplomata-Regular	Diplomata	regular
DiplomataSC-Regular	Diplomata SC	regular
DoHyeon-Regular	Do Hyeon	regular
Dokdo-Regular	Dokdo	regular
Domine[wght]	Domine	regular
DonegalOne-Regular	Donegal One	regular
Dongle-Bold	Dongle	bold
Dongle-Light	Dongle	light
Dongle-Regular	Dongle	regular
DoppioOne-Regular	Doppio One	regular
Dorsa-Regular	Dorsa	regular
Dosis[wght]	Dosis	regular
DotGothic16-Regular	DotGothic16	regular
DrSugiyama-Regular	Dr Sugiyama	regular
DuruSans-Regular	Duru Sans	regular
DynaPuff[wdth,wght]	DynaPuff	regular
Dynalight-Regular	Dynalight	regular
EBGaramond-Italic[wght]	EB Garamond	italic
EBGaramond[wght]	EB Garamond	regular
EagleLake-Regular	Eagle Lake	regular
EastSeaDokdo-Regular	East Sea Dokdo	regular
Eater-Regular	Eater	regular
Economica-Bold	Economica	bold
Economica-BoldItalic	Economica	bolditalic
Economica-Italic	Economica	italic
Economica-Regular	Economica	regular
Eczar[wght]	Eczar	regular
EduNSWACTFoundation[wght]	Edu NSW ACT Foundation	regular
EduQLDBeginner[wght]	Edu QLD Beginner	regular
EduSABeginner[wght]	Edu SA Beginner	regular
EduTASBeginner[wght]	Edu TAS Beginner	regular
EduVICWANTBeginner[wght]	Edu VIC WA NT Beginner	regular
EkMukta-Bold	Mukta	bold
EkMukta-ExtraBold	Mukta	extrabold
EkMukta-ExtraLight	Mukta	extralight
EkMukta-Light	Mukta	light
EkMukta-Medium	Mukta	medium
EkMukta-Regular	Mukta	regular
EkMukta-SemiBold	Mukta	semibold
ElMessiri[wght]	El Messiri	regular
Electrolize-Regular	Electrolize	regular
Elsie-Black	Elsie	black
Elsie-Regular	Elsie	regular
ElsieSwashCaps-Black	Elsie Swash Caps	black
ElsieSwashCaps-Regular	Elsie Swash Caps	regular
EmblemaOne-Regular	Emblema One	regular
EmilysCandy-Regular	Emilys Candy	regular
EncodeSansCondensed-Black	Encode Sans Condensed	black
EncodeSansCondensed-Bold	Encode Sans Condensed	bold
EncodeSansCondensed-ExtraBold	Encode Sans Condensed	extrabold
EncodeSansCondensed-ExtraLight	Encode Sans Condensed	extralight
EncodeSansCondensed-Light	Encode Sans Condensed	light
EncodeSansCondensed-Medium	Encode Sans Condensed	medium
EncodeSansCondensed-Regular	Encode Sans Condensed	regular
EncodeSansCondensed-SemiBold	Encode Sans Condensed	semibold
EncodeSansCondensed-Thin	Encode Sans Condensed	thin
EncodeSansExpanded-Black	Encode Sans Expanded	black
EncodeSansExpanded-Bold	Encode Sans Expanded	bold
EncodeSansExpanded-ExtraBold	Encode Sans Expanded	extrabold
EncodeSansExpanded-ExtraLight	Encode Sans Expanded	extralight
EncodeSansExpanded-Light	Encode Sans Expanded	light
EncodeSansExpanded-Medium	Encode Sans Expanded	medium
EncodeSansExpanded-Regular	Encode Sans Expanded	regular
EncodeSansExpanded-SemiBold	Encode Sans Expanded	semibold
EncodeSansExpanded-Thin	Encode Sans Expanded	thin
EncodeSansSC[wdth,wght]	Encode Sans SC	regular
EncodeSansSemiCondensed-Black	Encode Sans Semi Condensed	black
EncodeSansSemiCondensed-Bold	Encode Sans Semi Condensed	bold
EncodeSansSemiCondensed-ExtraBold	Encode Sans Semi Condensed	extrabold
EncodeSansSemiCondensed-ExtraLight	Encode Sans Semi Condensed	extralight
EncodeSansSemiCondensed-Light	Encode Sans Semi Condensed	light
EncodeSansSemiCondensed-Medium	Encode Sans Semi Condensed	medium
EncodeSansSemiCondensed-Regular	Encode Sans Semi Condensed	regular
EncodeSansSemiCondensed-SemiBold	Encode Sans Semi Condensed	semibold
EncodeSansSemiCondensed-Thin	Encode Sans Semi Condensed	thin
EncodeSansSemiExpanded-Black	Encode Sans Semi Expanded	black
EncodeSansSemiExpanded-Bold	Encode Sans Semi Expanded	bold
EncodeSansSemiExpanded-ExtraBold	Encode Sans Semi Expanded	extrabold
EncodeSansSemiExpanded-ExtraLight	Encode Sans Semi Expanded	extralight
EncodeSansSemiExpanded-Light	Encode Sans Semi Expanded	light
EncodeSansSemiExpanded-Medium	Encode Sans Semi Expanded	medium
EncodeSansSemiExpanded-Regular	Encode Sans Semi Expanded	regular
EncodeSansSemiExpanded-SemiBold	Encode Sans Semi Expanded	semibold
EncodeSansSemiExpanded-Thin	Encode Sans Semi Expanded	thin
EncodeSans[wdth,wght]	Encode Sans	regular
Engagement-Regular	Engagement	regular
Englebert-Regular	Englebert	regular
Enriqueta-Bold	Enriqueta	bold
Enriqueta-Medium	Enriqueta	medium
Enriqueta-Regular	Enriqueta	regular
Enriqueta-SemiBold	Enriqueta	semibold
Ephesis-Regular	Ephesis	regular
Epilogue-Italic[wght]	Epilogue	italic
Epilogue[wght]	Epilogue	regular
EricaOne-Regular	Erica One	regular
Esteban-Regular	Esteban	regular
Estonia-Regular	Estonia	regular
EuphoriaScript-Regular	Euphoria Script	regular
Ewert-Regular	Ewert	regular
Exo-Italic[wght]	Exo	italic
Exo2-Italic[wght]	Exo 2	italic
Exo2[wght]	Exo 2	regular
Exo[wght]	Exo	regular
ExpletusSans-Italic[wght]	Expletus Sans	italic
ExpletusSans[wght]	Expletus Sans	regular
Explora-Regular	Explora	regular
Fahkwang-Bold	Fahkwang	bold
Fahkwang-BoldItalic	Fahkwang	bolditalic
Fahkwang-ExtraLight	Fahkwang	extralight
Fahkwang-ExtraLightItalic	Fahkwang	extralightitalic
Fahkwang-Italic	Fahkwang	italic
Fahkwang-Light	Fahkwang	light
Fahkwang-LightItalic	Fahkwang	lightitalic
Fahkwang-Medium	Fahkwang	medium
Fahkwang-MediumItalic	Fahkwang	mediumitalic
Fahkwang-Regular	Fahkwang	regular
Fahkwang-SemiBold	Fahkwang	semibold
Fahkwang-SemiBoldItalic	Fahkwang	semibolditalic
FamiljenGrotesk-Italic[wght]	Familjen Grotesk	italic
FamiljenGrotesk[wght]	Familjen Grotesk	regular
FanwoodText-Italic	Fanwood Text	italic
FanwoodText-Regular	Fanwood Text	regular
Farro-Bold	Farro	bold
Farro-Light	Farro	light
Farro-Medium	Farro	medium
Farro-Regular	Farro	regular
Farsan-Regular	Farsan	regular
Fascinate-Regular	Fascinate	regular
FascinateInline-Regular	Fascinate Inline	regular
FasterOne-Regular	Faster One	regular
Fasthand-Regular	Fasthand	regular
FaunaOne-Regular	Fauna One	regular
Faustina-Italic[wght]	Faustina	italic
Faustina[wght]	Faustina	regular
Federant-Regular	Federant	regular
Federo-Regular	Federo	regular
Felipa-Regular	Felipa	regular
Fenix-Regular	Fenix	regular
Festive-Regular	Festive	regular
Figtree-Italic[wght]	Figtree	italic
Figtree[wght]	Figtree	regular
FingerPaint-Regular	Finger Paint	regular
Finlandica-Italic[wght]	Finlandica	italic
Finlandica[wght]	Finlandica	regular
FiraCode[wght]	Fira Code	regular
FiraMono-Bold	Fira Mono	bold
FiraMono-Medium	Fira Mono	medium
FiraMono-Regular	Fira Mono	regular
FiraSans-Black	Fira Sans	black
FiraSans-BlackItalic	Fira Sans	blackitalic
FiraSans-Bold	Fira Sans	bold
FiraSans-BoldItalic	Fira Sans	bolditalic
FiraSans-ExtraBold	Fira Sans	extrabold
FiraSans-ExtraBoldItalic	Fira Sans	extrabolditalic
FiraSans-ExtraLight	Fira Sans	extralight
FiraSans-ExtraLightItalic	Fira Sans	extralightitalic
FiraSans-Italic	Fira Sans	italic
FiraSans-Light	Fira Sans	light
FiraSans-LightItalic	Fira Sans	lightitalic
FiraSans-Medium	Fira Sans	medium
FiraSans-MediumItalic	Fira Sans	mediumitalic
FiraSans-Regular	Fira Sans	regular
FiraSans-SemiBold	Fira Sans	semibold
FiraSans-SemiBoldItalic	Fira Sans	semibolditalic
FiraSans-Thin	Fira Sans	thin
FiraSans-ThinItalic	Fira Sans	thinitalic
FiraSansCondensed-Black	Fira Sans Condensed	black
FiraSansCondensed-BlackItalic	Fira Sans Condensed	blackitalic
FiraSansCondensed-Bold	Fira Sans Condensed	bold
FiraSansCondensed-BoldItalic	Fira Sans Condensed	bolditalic
FiraSansCondensed-ExtraBold	Fira Sans Condensed	extrabold
FiraSansCondensed-ExtraBoldItalic	Fira Sans Condensed	extrabolditalic
FiraSansCondensed-ExtraLight	Fira Sans Condensed	extralight
FiraSansCondensed-ExtraLightItalic	Fira Sans Condensed	extralightitalic
FiraSansCondensed-Italic	Fira Sans Condensed	italic
FiraSansCondensed-Light	Fira Sans Condensed	light
FiraSansCondensed-LightItalic	Fira Sans Condensed	lightitalic
FiraSansCondensed-Medium	Fira Sans Condensed	medium
FiraSansCondensed-MediumItalic	Fira Sans Condensed	mediumitalic
FiraSansCondensed-Regular	Fira Sans Condensed	regular
FiraSansCondensed-SemiBold	Fira Sans Condensed	semibold
FiraSansCondensed-SemiBoldItalic	Fira Sans Condensed	semibolditalic
FiraSansCondensed-Thin	Fira Sans Condensed	thin
FiraSansCondensed-ThinItalic	Fira Sans Condensed	thinitalic
FiraSansExtraCondensed-Black	Fira Sans Extra Condensed	black
FiraSansExtraCondensed-BlackItalic	Fira Sans Extra Condensed	blackitalic
FiraSansExtraCondensed-Bold	Fira Sans Extra Condensed	bold
FiraSansExtraCondensed-BoldItalic	Fira Sans Extra Condensed	bolditalic
FiraSansExtraCondensed-ExtraBold	Fira Sans Extra Condensed	extrabold
FiraSansExtraCondensed-ExtraBoldItalic	Fira Sans Extra Condensed	extrabolditalic
FiraSansExtraCondensed-ExtraLight	Fira Sans Extra Condensed	extralight
FiraSansExtraCondensed-ExtraLightItalic	Fira Sans Extra Condensed	extralightitalic
FiraSansExtraCondensed-Italic	Fira Sans Extra Condensed	italic
FiraSansExtraCondensed-Light	Fira Sans Extra Condensed	light
FiraSansExtraCondensed-LightItalic	Fira Sans Extra Condensed	lightitalic
FiraSansExtraCondensed-Medium	Fira Sans Extra Condensed	medium
FiraSansExtraCondensed-MediumItalic	Fira Sans Extra Condensed	mediumitalic
FiraSansExtraCondensed-Regular	Fira Sans Extra Condensed	regular
FiraSansExtraCondensed-SemiBold	Fira Sans Extra Condensed	semibold
FiraSansExtraCondensed-SemiBoldItalic	Fira Sans Extra Condensed	semibolditalic
FiraSansExtraCondensed-Thin	Fira Sans Extra Condensed	thin
FiraSansExtraCondensed-ThinItalic	Fira Sans Extra Condensed	thinitalic
FjallaOne-Regular	Fjalla One	regular
FjordOne-Regular	Fjord One	regular
Flamenco-Light	Flamenco	light
Flamenco-Regular	Flamenco	regular
Flavors-Regular	Flavors	regular
FleurDeLeah-Regular	Fleur De Leah	regular
FlowBlock-Regular	Flow Block	regular
FlowCircular-Regular	Flow Circular	regular
FlowRounded-Regular	Flow Rounded	regular
Foldit[wght]	Foldit	regular
Fondamento-Italic	Fondamento	italic
Fondamento-Regular	Fondamento	regular
FontdinerSwanky-Regular	Fontdiner Swanky	regular
Forum-Regular	Forum	regular
FragmentMono-Italic	Fragment Mono	italic
FragmentMono-Regular	Fragment Mono	regular
FrancoisOne-Regular	Francois One	regular
FrankRuhlLibre[wght]	Frank Ruhl Libre	regular
Fraunces-Italic[SOFT,WONK,opsz,wght]	Fraunces	italic
Fraunces[SOFT,WONK,opsz,wght]	Fraunces	regular
FreckleFace-Regular	Freckle Face	regular
FrederickatheGreat-Regular	Fredericka the Great	regular
Fredoka[wdth,wght]	Fredoka	regular
Freehand-Regular	Freehand	regular
Fresca-Regular	Fresca	regular
Frijole-Regular	Frijole	regular
Fruktur-Italic	Fruktur	italic
Fruktur-Regular	Fruktur	regular
FugazOne-Regular	Fugaz One	regular
Fuggles-Regular	Fuggles	regular
FuzzyBubbles-Bold	Fuzzy Bubbles	bold
FuzzyBubbles-Regular	Fuzzy Bubbles	regular
GFSDidot-Regular	GFS Didot	regular
GFSNeohellenic	GFS Neohellenic	regular
GFSNeohellenicBold	GFS Neohellenic	bold
GFSNeohellenicBoldItalic	GFS Neohellenic	bolditalic
GFSNeohellenicItalic	GFS Neohellenic	italic
Gabarito[wght]	Gabarito	regular
Gabriela-Regular	Gabriela	regular
Gaegu-Bold	Gaegu	bold
Gaegu-Light	Gaegu	light
Gaegu-Regular	Gaegu	regular
Gafata-Regular	Gafata	regular
GajrajOne-Regular	Gajraj One	regular
Galada-Regular	Galada	regular
Galdeano-Regular	Galdeano	regular
Galindo-Regular	Galindo	regular
GamjaFlower-Regular	Gamja Flower	regular
Gantari-Italic[wght]	Gantari	italic
Gantari[wght]	Gantari	regular
GasoekOne-Regular	Gasoek One	regular
Gayathri-Bold	Gayathri	bold
Gayathri-Regular	Gayathri	regular
Gayathri-Thin	Gayathri	thin
Gelasio-Bold	Gelasio	bold
Gelasio-BoldItalic	Gelasio	bolditalic
Gelasio-Italic	Gelasio	italic
Gelasio-Medium	Gelasio	medium
Gelasio-MediumItalic	Gelasio	mediumitalic
Gelasio-Regular	Gelasio	regular
Gelasio-SemiBold	Gelasio	semibold
Gelasio-SemiBoldItalic	Gelasio	semibolditalic
GemunuLibre[wght]	Gemunu Libre	regular
Genos-Italic[wght]	Genos	italic
Genos[wght]	Genos	regular
GentiumBookPlus-Bold	Gentium Book Plus	bold
GentiumBookPlus-BoldItalic	Gentium Book Plus	bolditalic
GentiumBookPlus-Italic	Gentium Book Plus	italic
GentiumBookPlus-Regular	Gentium Book Plus	regular
GentiumPlus-Bold	Gentium Plus	bold
GentiumPlus-BoldItalic	Gentium Plus	bolditalic
GentiumPlus-Italic	Gentium Plus	italic
GentiumPlus-Regular	Gentium Plus	regular
Geo-Oblique	Geo	oblique
Geo-Regular	Geo	regular
Geologica[CRSV,SHRP,slnt,wght]	Geologica	regular
Georama-Italic[wdth,wght]	Georama	italic
Georama[wdth,wght]	Georama	regular
Georgia	NONE	regular
Geostar-Regular	Geostar	regular
GeostarFill-Regular	Geostar Fill	regular
GermaniaOne-Regular	Germania One	regular
GideonRoman-Regular	Gideon Roman	regular
Gidugu-Regular	Gidugu	regular
GildaDisplay-Regular	Gilda Display	regular
Girassol-Regular	Girassol	regular
GiveYouGlory	Give You Glory	regular
GlassAntiqua-Regular	Glass Antiqua	regular
Glegoo-Bold	Glegoo	bold
Glegoo-Regular	Glegoo	regular
Gloock-Regular	Gloock	regular
GloriaHallelujah	Gloria Hallelujah	regular
Glory-Italic[wght]	Glory	italic
Glory[wght]	Glory	regular
Gluten[slnt,wght]	Gluten	regular
GoblinOne	Goblin One	regular
GochiHand-Regular	Gochi Hand	regular
Goldman-Bold	Goldman	bold
Goldman-Regular	Goldman	regular
GolosText[wght]	Golos Text	regular
Gorditas-Bold	Gorditas	bold
Gorditas-Regular	Gorditas	regular
GothicA1-Black	Gothic A1	black
GothicA1-Bold	Gothic A1	bold
GothicA1-ExtraBold	Gothic A1	extrabold
GothicA1-ExtraLight	Gothic A1	extralight
GothicA1-Light	Gothic A1	light
GothicA1-Medium	Gothic A1	medium
GothicA1-Regular	Gothic A1	regular
GothicA1-SemiBold	Gothic A1	semibold
GothicA1-Thin	Gothic A1	thin
Gotu-Regular	Gotu	regular
GoudyBookletter1911	Goudy Bookletter 1911	regular
GowunBatang-Bold	Gowun Batang	bold
GowunBatang-Regular	Gowun Batang	regular
GowunDodum-Regular	Gowun Dodum	regular
Graduate-Regular	Graduate	regular
GrandHotel-Regular	Grand Hotel	regular
GrandifloraOne-Regular	Grandiflora One	regular
Grandstander-Italic[wght]	Grandstander	italic
Grandstander[wght]	Grandstander	regular
GrapeNuts-Regular	Grape Nuts	regular
GravitasOne	Gravitas One	regular
GreatVibes-Regular	Great Vibes	regular
GrechenFuemen-Regular	Grechen Fuemen	regular
Grenze-Black	Grenze	black
Grenze-BlackItalic	Grenze	blackitalic
Grenze-Bold	Grenze	bold
Grenze-BoldItalic	Grenze	bolditalic
Grenze-ExtraBold	Grenze	extrabold
Grenze-ExtraBoldItalic	Grenze	extrabolditalic
Grenze-ExtraLight	Grenze	extralight
Grenze-ExtraLightItalic	Grenze	extralightitalic
Grenze-Italic	Grenze	italic
Grenze-Light	Grenze	light
Grenze-LightItalic	Grenze	lightitalic
Grenze-Medium	Grenze	medium
Grenze-MediumItalic	Grenze	mediumitalic
Grenze-Regular	Grenze	regular
Grenze-SemiBold	Grenze	semibold
Grenze-SemiBoldItalic	Grenze	semibolditalic
Grenze-Thin	Grenze	thin
Grenze-ThinItalic	Grenze	thinitalic
GrenzeGotisch[wght]	Grenze Gotisch	regular
GreyQo-Regular	Grey Qo	regular
Griffy-Regular	Griffy	regular
Gruppo-Regular	Gruppo	regular
Gudea-Bold	Gudea	bold
Gudea-Italic	Gudea	italic
Gudea-Regular	Gudea	regular
Gugi-Regular	Gugi	regular
Gulzar-Regular	Gulzar	regular
Gupter-Bold	Gupter	bold
Gupter-Medium	Gupter	medium
Gupter-Regular	Gupter	regular
Gurajada-Regular	Gurajada	regular
Gwendolyn-Bold	Gwendolyn	bold
Gwendolyn-Regular	Gwendolyn	regular
Habibi-Regular	Habibi	regular
HachiMaruPop-Regular	Hachi Maru Pop	regular
Hahmlet[wght]	Hahmlet	regular
Halant-Bold	Halant	bold
Halant-Light	Halant	light
Halant-Medium	Halant	medium
Halant-Regular	Halant	regular
Halant-SemiBold	Halant	semibold
HammersmithOne-Regular	Hammersmith One	regular
Hanalei-Regular	Hanalei	regular
HanaleiFill-Regular	Hanalei Fill	regular
Handjet[ELGR,ELSH,wght]	Handjet	regular
Handlee-Regular	Handlee	regular
HankenGrotesk-Italic[wght]	Hanken Grotesk	italic
HankenGrotesk[wght]	Hanken Grotesk	regular
Hannari-Regular	NONE	regular
Hanuman-Black	Hanuman	black
Hanuman-Bold	Hanuman	bold
Hanuman-Light	Hanuman	light
Hanuman-Regular	Hanuman	regular
Hanuman-Thin	Hanuman	thin
HappyMonkey-Regular	Happy Monkey	regular
Harmattan-Bold	Harmattan	bold
Harmattan-Medium	Harmattan	medium
Harmattan-Regular	Harmattan	regular
Harmattan-SemiBold	Harmattan	semibold
HeadlandOne-Regular	Headland One	regular
HedvigLettersSans-Regular	Hedvig Letters Sans	regular
HedvigLettersSerif[opsz]	Hedvig Letters Serif	regular
Heebo[wght]	Heebo	regular
HennyPenny-Regular	Henny Penny	regular
HeptaSlab[wght]	Hepta Slab	regular
HermeneusOne-Regular	NONE	regular
HerrVonMuellerhoff-Regular	Herr Von Muellerhoff	regular
HiMelody-Regular	Hi Melody	regular
HinaMincho-Regular	Hina Mincho	regular
Hind-Bold	Hind	bold
Hind-Light	Hind	light
Hind-Medium	Hind	medium
Hind-Regular	Hind	regular
Hind-SemiBold	Hind	semibold
HindColombo-Bold	NONE	bold
HindColombo-Light	NONE	light
HindColombo-Medium	NONE	medium
HindColombo-Regular	NONE	regular
HindColombo-SemiBold	NONE	semibold
HindGuntur-Bold	Hind Guntur	bold
HindGuntur-Light	Hind Guntur	light
HindGuntur-Medium	Hind Guntur	medium
HindGuntur-Regular	Hind Guntur	regular
HindGuntur-SemiBold	Hind Guntur	semibold
HindJalandhar-Bold	NONE	bold
HindJalandhar-Light	NONE	light
HindJalandhar-Medium	NONE	medium
HindJalandhar-Regular	NONE	regular
HindJalandhar-SemiBold	NONE	semibold
HindKochi-Bold	NONE	bold
HindKochi-Light	NONE	light
HindKochi-Medium	NONE	medium
HindKochi-Regular	NONE	regular
HindKochi-SemiBold	NONE	semibold
HindMadurai-Bold	Hind Madurai	bold
HindMadurai-Light	Hind Madurai	light
HindMadurai-Medium	Hind Madurai	medium
HindMadurai-Regular	Hind Madurai	regular
HindMadurai-SemiBold	Hind Madurai	semibold
HindMysuru-Bold	NONE	bold
HindMysuru-Light	NONE	light
HindMysuru-Medium	NONE	medium
HindMysuru-Regular	NONE	regular
HindMysuru-SemiBold	NONE	semibold
HindSiliguri-Bold	Hind Siliguri	bold
HindSiliguri-Light	Hind Siliguri	light
HindSiliguri-Medium	Hind Siliguri	medium
HindSiliguri-Regular	Hind Siliguri	regular
HindSiliguri-SemiBold	Hind Siliguri	semibold
HindVadodara-Bold	Hind Vadodara	bold
HindVadodara-Light	Hind Vadodara	light
HindVadodara-Medium	Hind Vadodara	medium
HindVadodara-Regular	Hind Vadodara	regular
HindVadodara-SemiBold	Hind Vadodara	semibold
HoltwoodOneSC	Holtwood One SC	regular
HomemadeApple-Regular	Homemade Apple	regular
Homenaje-Regular	Homenaje	regular
Hubballi-Regular	Hubballi	regular
Hurricane-Regular	Hurricane	regular
IBMPlexMono-Bold	IBM Plex Mono	bold
IBMPlexMono-BoldItalic	IBM Plex Mono	bolditalic
IBMPlexMono-ExtraLight	IBM Plex Mono	extralight
IBMPlexMono-ExtraLightItalic	IBM Plex Mono	extralightitalic
IBMPlexMono-Italic	IBM Plex Mono	italic
IBMPlexMono-Light	IBM Plex Mono	light
IBMPlexMono-LightItalic	IBM Plex Mono	lightitalic
IBMPlexMono-Medium	IBM Plex Mono	medium
IBMPlexMono-MediumItalic	IBM Plex Mono	mediumitalic
IBMPlexMono-Regular	IBM Plex Mono	regular
IBMPlexMono-SemiBold	IBM Plex Mono	semibold
IBMPlexMono-SemiBoldItalic	IBM Plex Mono	semibolditalic
IBMPlexMono-Thin	IBM Plex Mono	thin
IBMPlexMono-ThinItalic	IBM Plex Mono	thinitalic
IBMPlexSans-Bold	IBM Plex Sans	bold
IBMPlexSans-BoldItalic	IBM Plex Sans	bolditalic
IBMPlexSans-ExtraLight	IBM Plex Sans	extralight
IBMPlexSans-ExtraLightItalic	IBM Plex Sans	extralightitalic
IBMPlexSans-Italic	IBM Plex Sans	italic
IBMPlexSans-Light	IBM Plex Sans	light
IBMPlexSans-LightItalic	IBM Plex Sans	lightitalic
IBMPlexSans-Medium	IBM Plex Sans	medium
IBMPlexSans-MediumItalic	IBM Plex Sans	mediumitalic
IBMPlexSans-Regular	IBM Plex Sans	regular
IBMPlexSans-SemiBold	IBM Plex Sans	semibold
IBMPlexSans-SemiBoldItalic	IBM Plex Sans	semibolditalic
IBMPlexSans-Thin	IBM Plex Sans	thin
IBMPlexSans-ThinItalic	IBM Plex Sans	thinitalic
IBMPlexSansArabic-Bold	IBM Plex Sans Arabic	bold
IBMPlexSansArabic-ExtraLight	IBM Plex Sans Arabic	extralight
IBMPlexSansArabic-Light	IBM Plex Sans Arabic	light
IBMPlexSansArabic-Medium	IBM Plex Sans Arabic	medium
IBMPlexSansArabic-Regular	IBM Plex Sans Arabic	regular
IBMPlexSansArabic-SemiBold	IBM Plex Sans Arabic	semibold
IBMPlexSansArabic-Thin	IBM Plex Sans Arabic	thin
IBMPlexSansCondensed-Bold	IBM Plex Sans Condensed	bold
IBMPlexSansCondensed-BoldItalic	IBM Plex Sans Condensed	bolditalic
IBMPlexSansCondensed-ExtraLight	IBM Plex Sans Condensed	extralight
IBMPlexSansCondensed-ExtraLightItalic	IBM Plex Sans Condensed	extralightitalic
IBMPlexSansCondensed-Italic	IBM Plex Sans Condensed	italic
IBMPlexSansCondensed-Light	IBM Plex Sans Condensed	light
IBMPlexSansCondensed-LightItalic	IBM Plex Sans Condensed	lightitalic
IBMPlexSansCondensed-Medium	IBM Plex Sans Condensed	medium
IBMPlexSansCondensed-MediumItalic	IBM Plex Sans Condensed	mediumitalic
IBMPlexSansCondensed-Regular	IBM Plex Sans Condensed	regular
IBMPlexSansCondensed-SemiBold	IBM Plex Sans Condensed	semibold
IBMPlexSansCondensed-SemiBoldItalic	IBM Plex Sans Condensed	semibolditalic
IBMPlexSansCondensed-Thin	IBM Plex Sans Condensed	thin
IBMPlexSansCondensed-ThinItalic	IBM Plex Sans Condensed	thinitalic
IBMPlexSansDevanagari-Bold	IBM Plex Sans Devanagari	bold
IBMPlexSansDevanagari-ExtraLight	IBM Plex Sans Devanagari	extralight
IBMPlexSansDevanagari-Light	IBM Plex Sans Devanagari	light
IBMPlexSansDevanagari-Medium	IBM Plex Sans Devanagari	medium
IBMPlexSansDevanagari-Regular	IBM Plex Sans Devanagari	regular
IBMPlexSansDevanagari-SemiBold	IBM Plex Sans Devanagari	semibold
IBMPlexSansDevanagari-Thin	IBM Plex Sans Devanagari	thin
IBMPlexSansHebrew-Bold	IBM Plex Sans Hebrew	bold
IBMPlexSansHebrew-ExtraLight	IBM Plex Sans Hebrew	extralight
IBMPlexSansHebrew-Light	IBM Plex Sans Hebrew	light
IBMPlexSansHebrew-Medium	IBM Plex Sans Hebrew	medium
IBMPlexSansHebrew-Regular	IBM Plex Sans Hebrew	regular
IBMPlexSansHebrew-SemiBold	IBM Plex Sans Hebrew	semibold
IBMPlexSansHebrew-Thin	IBM Plex Sans Hebrew	thin
IBMPlexSansJP-Bold	IBM Plex Sans JP	bold
IBMPlexSansJP-ExtraLight	IBM Plex Sans JP	extralight
IBMPlexSansJP-Light	IBM Plex Sans JP	light
IBMPlexSansJP-Medium	IBM Plex Sans JP	medium
IBMPlexSansJP-Regular	IBM Plex Sans JP	regular
IBMPlexSansJP-SemiBold	IBM Plex Sans JP	semibold
IBMPlexSansJP-Thin	IBM Plex Sans JP	thin
IBMPlexSansKR-Bold	IBM Plex Sans KR	bold
IBMPlexSansKR-ExtraLight	IBM Plex Sans KR	extralight
IBMPlexSansKR-Light	IBM Plex Sans KR	light
IBMPlexSansKR-Medium	IBM Plex Sans KR	medium
IBMPlexSansKR-Regular	IBM Plex Sans KR	regular
IBMPlexSansKR-SemiBold	IBM Plex Sans KR	semibold
IBMPlexSansKR-Thin	IBM Plex Sans KR	thin
IBMPlexSansThai-Bold	IBM Plex Sans Thai	bold
IBMPlexSansThai-ExtraLight	IBM Plex Sans Thai	extralight
IBMPlexSansThai-Light	IBM Plex Sans Thai	light
IBMPlexSansThai-Medium	IBM Plex Sans Thai	medium
IBMPlexSansThai-Regular	IBM Plex Sans Thai	regular
IBMPlexSansThai-SemiBold	IBM Plex Sans Thai	semibold
IBMPlexSansThai-Thin	IBM Plex Sans Thai	thin
IBMPlexSansThaiLooped-Bold	IBM Plex Sans Thai Looped	bold
IBMPlexSansThaiLooped-ExtraLight	IBM Plex Sans Thai Looped	extralight
IBMPlexSansThaiLooped-Light	IBM Plex Sans Thai Looped	light
IBMPlexSansThaiLooped-Medium	IBM Plex Sans Thai Looped	medium
IBMPlexSansThaiLooped-Regular	IBM Plex Sans Thai Looped	regular
IBMPlexSansThaiLooped-SemiBold	IBM Plex Sans Thai Looped	semibold
IBMPlexSansThaiLooped-Thin	IBM Plex Sans Thai Looped	thin
IBMPlexSerif-Bold	IBM Plex Serif	bold
IBMPlexSerif-BoldItalic	IBM Plex Serif	bolditalic
IBMPlexSerif-ExtraLight	IBM Plex Serif	extralight
IBMPlexSerif-ExtraLightItalic	IBM Plex Serif	extralightitalic
IBMPlexSerif-Italic	IBM Plex Serif	italic
IBMPlexSerif-Light	IBM Plex Serif	light
IBMPlexSerif-LightItalic	IBM Plex Serif	lightitalic
IBMPlexSerif-Medium	IBM Plex Serif	medium
IBMPlexSerif-MediumItalic	IBM Plex Serif	mediumitalic
IBMPlexSerif-Regular	IBM Plex Serif	regular
IBMPlexSerif-SemiBold	IBM Plex Serif	semibold
IBMPlexSerif-SemiBoldItalic	IBM Plex Serif	semibolditalic
IBMPlexSerif-Thin	IBM Plex Serif	thin
IBMPlexSerif-ThinItalic	IBM Plex Serif	thinitalic
IMFELLDoublePica-Italic	IM Fell Double Pica	italic
IMFELLDoublePica-Regular	IM Fell Double Pica	regular
IMFeDPsc28P	NONE	regular
IMFeENit28P	NONE	regular
IMFeENrm28P	NONE	regular
IMFeENsc28P	NONE	regular
IMFeFCit28P	NONE	regular
IMFeFCrm28P	NONE	regular
IMFeFCsc28P	NONE	regular
IMFeGPit28P	NONE	regular
IMFeGPrm28P	NONE	regular
IMFeGPsc28P	NONE	regular
IMFePIit28P	NONE	regular
IMFePIrm28P	NONE	regular
IMFePIsc28P	NONE	regular
IbarraRealNova-Italic[wght]	Ibarra Real Nova	italic
IbarraRealNova[wght]	Ibarra Real Nova	regular
Iceberg-Regular	Iceberg	regular
Iceland-Regular	Iceland	regular
Imbue[opsz,wght]	Imbue	regular
ImperialScript-Regular	Imperial Script	regular
Imprima-Regular	Imprima	regular
InclusiveSans-Italic	Inclusive Sans	italic
InclusiveSans-Regular	Inclusive Sans	regular
Inconsolata[wdth,wght]	Inconsolata	regular
Inder-Regular	Inder	regular
IndieFlower-Regular	Indie Flower	regular
IngridDarling-Regular	Ingrid Darling	regular
Inika-Bold	Inika	bold
Inika-Regular	Inika	regular
InknutAntiqua-Black	Inknut Antiqua	black
InknutAntiqua-Bold	Inknut Antiqua	bold
InknutAntiqua-ExtraBold	Inknut Antiqua	extrabold
InknutAntiqua-Light	Inknut Antiqua	light
InknutAntiqua-Medium	Inknut Antiqua	medium
InknutAntiqua-Regular	Inknut Antiqua	regular
InknutAntiqua-SemiBold	Inknut Antiqua	semibold
InriaSans-Bold	Inria Sans	bold
InriaSans-BoldItalic	Inria Sans	bolditalic
InriaSans-Italic	Inria Sans	italic
InriaSans-Light	Inria Sans	light
InriaSans-LightItalic	Inria Sans	lightitalic
InriaSans-Regular	Inria Sans	regular
InriaSerif-Bold	Inria Serif	bold
InriaSerif-BoldItalic	Inria Serif	bolditalic
InriaSerif-Italic	Inria Serif	italic
InriaSerif-Light	Inria Serif	light
InriaSerif-LightItalic	Inria Serif	lightitalic
InriaSerif-Regular	Inria Serif	regular
Inspiration-Regular	Inspiration	regular
InstrumentSans-Italic[wdth,wght]	Instrument Sans	italic
InstrumentSans[wdth,wght]	Instrument Sans	regular
InstrumentSerif-Italic	Instrument Serif	italic
InstrumentSerif-Regular	Instrument Serif	regular
InterTight-Italic[wght]	Inter Tight	italic
InterTight[wght]	Inter Tight	regular
Inter[slnt,wght]	Inter	regular
IrishGrover-Regular	Irish Grover	regular
IslandMoments-Regular	Island Moments	regular
IstokWeb-Bold	Istok Web	bold
IstokWeb-BoldItalic	Istok Web	bolditalic
IstokWeb-Italic	Istok Web	italic
IstokWeb-Regular	Istok Web	regular
Italiana-Regular	Italiana	regular
Italianno-Regular	Italianno	regular
Itim-Regular	Itim	regular
JacquesFrancois-Regular	Jacques Francois	regular
JacquesFrancoisShadow-Regular	Jacques Francois Shadow	regular
Jaldi-Bold	Jaldi	bold
Jaldi-Regular	Jaldi	regular
JejuGothic-Regular	NONE	regular
JejuHallasan-Regular	NONE	regular
JejuMyeongjo-Regular	NONE	regular
JetBrainsMono-Italic[wght]	JetBrains Mono	italic
JetBrainsMono[wght]	JetBrains Mono	regular
JimNightshade-Regular	Jim Nightshade	regular
Joan-Regular	Joan	regular
JockeyOne-Regular	Jockey One	regular
JollyLodger-Regular	Jolly Lodger	regular
Jomhuria-Regular	Jomhuria	regular
Jomolhari-Regular	Jomolhari	regular
JosefinSans-Italic[wght]	Josefin Sans	italic
JosefinSans[wght]	Josefin Sans	regular
JosefinSlab-Italic[wght]	Josefin Slab	italic
JosefinSlab[wght]	Josefin Slab	regular
Jost-Italic[wght]	Jost	italic
Jost[wght]	Jost	regular
JotiOne-Regular	Joti One	regular
Jua-Regular	Jua	regular
Judson-Bold	Judson	bold
Judson-Italic	Judson	italic
Judson-Regular	Judson	regular
Julee-Regular	Julee	regular
JuliusSansOne-Regular	Julius Sans One	regular
Junge-Regular	Junge	regular
Jura[wght]	Jura	regular
JustAnotherHand-Regular	Just Another Hand	regular
JustMeAgainDownHere	Just Me Again Down Here	regular
K2D-Bold	K2D	bold
K2D-BoldItalic	K2D	bolditalic
K2D-ExtraBold	K2D	extrabold
K2D-ExtraBoldItalic	K2D	extrabolditalic
K2D-ExtraLight	K2D	extralight
K2D-ExtraLightItalic	K2D	extralightitalic
K2D-Italic	K2D	italic
K2D-Light	K2D	light
K2D-LightItalic	K2D	lightitalic
K2D-Medium	K2D	medium
K2D-MediumItalic	K2D	mediumitalic
K2D-Regular	K2D	regular
K2D-SemiBold	K2D	semibold
K2D-SemiBoldItalic	K2D	semibolditalic
K2D-Thin	K2D	thin
K2D-ThinItalic	K2D	thinitalic
Kablammo[MORF]	Kablammo	regular
Kadwa-Bold	Kadwa	bold
Kadwa-Regular	Kadwa	regular
KaiseiDecol-Bold	Kaisei Decol	bold
KaiseiDecol-Medium	Kaisei Decol	medium
KaiseiDecol-Regular	Kaisei Decol	regular
KaiseiHarunoUmi-Bold	Kaisei HarunoUmi	bold
KaiseiHarunoUmi-Medium	Kaisei HarunoUmi	medium
KaiseiHarunoUmi-Regular	Kaisei HarunoUmi	regular
KaiseiOpti-Bold	Kaisei Opti	bold
KaiseiOpti-Medium	Kaisei Opti	medium
KaiseiOpti-Regular	Kaisei Opti	regular
KaiseiTokumin-Bold	Kaisei Tokumin	bold
KaiseiTokumin-ExtraBold	Kaisei Tokumin	extrabold
KaiseiTokumin-Medium	Kaisei Tokumin	medium
KaiseiTokumin-Regular	Kaisei Tokumin	regular
Kalam-Bold	Kalam	bold
Kalam-Light	Kalam	light
Kalam-Regular	Kalam	regular
Kalnia[wdth,wght]	Kalnia	regular
Kameron[wght]	Kameron	regular
Kanit-Black	Kanit	black
Kanit-BlackItalic	Kanit	blackitalic
Kanit-Bold	Kanit	bold
Kanit-BoldItalic	Kanit	bolditalic
Kanit-ExtraBold	Kanit	extrabold
Kanit-ExtraBoldItalic	Kanit	extrabolditalic
Kanit-ExtraLight	Kanit	extralight
Kanit-ExtraLightItalic	Kanit	extralightitalic
Kanit-Italic	Kanit	italic
Kanit-Light	Kanit	light
Kanit-LightItalic	Kanit	lightitalic
Kanit-Medium	Kanit	medium
Kanit-MediumItalic	Kanit	mediumitalic
Kanit-Regular	Kanit	regular
Kanit-SemiBold	Kanit	semibold
Kanit-SemiBoldItalic	Kanit	semibolditalic
Kanit-Thin	Kanit	thin
Kanit-ThinItalic	Kanit	thinitalic
KantumruyPro-Italic[wght]	Kantumruy Pro	italic
KantumruyPro[wght]	Kantumruy Pro	regular
Kapakana[wght]	NONE	regular
Karantina-Bold	Karantina	bold
Karantina-Light	Karantina	light
Karantina-Regular	Karantina	regular
Karla-Italic[wght]	Karla	italic
KarlaTamilInclined-Bold	NONE	bold
KarlaTamilInclined-Regular	NONE	regular
KarlaTamilUpright-Bold	NONE	bold
KarlaTamilUpright-Regular	NONE	regular
Karla[wght]	Karla	regular
Karma-Bold	Karma	bold
Karma-Light	Karma	light
Karma-Medium	Karma	medium
Karma-Regular	Karma	regular
Karma-SemiBold	Karma	semibold
Katibeh-Regular	Katibeh	regular
KaushanScript-Regular	Kaushan Script	regular
Kavivanar-Regular	Kavivanar	regular
Kavoon-Regular	Kavoon	regular
KayPhoDu-Bold	Kay Pho Du	bold
KayPhoDu-Medium	Kay Pho Du	medium
KayPhoDu-Regular	Kay Pho Du	regular
KayPhoDu-SemiBold	Kay Pho Du	semibold
KdamThmorPro-Regular	Kdam Thmor Pro	regular
KeaniaOne-Regular	Keania One	regular
KellySlab-Regular	Kelly Slab	regular
Kenia-Regular	Kenia	regular
Khand-Bold	Khand	bold
Khand-Light	Khand	light
Khand-Medium	Khand	medium
Khand-Regular	Khand	regular
Khand-SemiBold	Khand	semibold
Khmer	Khmer	regular
Khula-Bold	Khula	bold
Khula-ExtraBold	Khula	extrabold
Khula-Light	Khula	light
Khula-Regular	Khula	regular
Khula-SemiBold	Khula	semibold
Khyay-Regular	NONE	regular
Kings-Regular	Kings	regular
KirangHaerang-Regular	Kirang Haerang	regular
KiteOne-Regular	Kite One	regular
KiwiMaru-Light	Kiwi Maru	light
KiwiMaru-Medium	Kiwi Maru	medium
KiwiMaru-Regular	Kiwi Maru	regular
KleeOne-Regular	Klee One	regular
KleeOne-SemiBold	Klee One	semibold
Knewave-Regular	Knewave	regular
KoHo-Bold	NONE	bold
KoHo-BoldItalic	NONE	bolditalic
KoHo-ExtraLight	NONE	extralight
KoHo-ExtraLightItalic	NONE	extralightitalic
KoHo-Italic	NONE	italic
KoHo-Light	NONE	light
KoHo-LightItalic	NONE	lightitalic
KoHo-Medium	NONE	medium
KoHo-MediumItalic	NONE	mediumitalic
KoHo-Regular	NONE	regular
KoHo-SemiBold	NONE	semibold
KoHo-SemiBoldItalic	NONE	semibolditalic
KoPubBatang-Bold	NONE	bold
KoPubBatang-Light	NONE	light
KoPubBatang-Regular	NONE	regular
Kodchasan-Bold	Kodchasan	bold
Kodchasan-BoldItalic	Kodchasan	bolditalic
Kodchasan-ExtraLight	Kodchasan	extralight
Kodchasan-ExtraLightItalic	Kodchasan	extralightitalic
Kodchasan-Italic	Kodchasan	italic
Kodchasan-Light	Kodchasan	light
Kodchasan-LightItalic	Kodchasan	lightitalic
Kodchasan-Medium	Kodchasan	medium
Kodchasan-MediumItalic	Kodchasan	mediumitalic
Kodchasan-Regular	Kodchasan	regular
Kodchasan-SemiBold	Kodchasan	semibold
Kodchasan-SemiBoldItalic	Kodchasan	semibolditalic
KohSantepheap-Black	Koh Santepheap	black
KohSantepheap-Bold	Koh Santepheap	bold
KohSantepheap-Light	Koh Santepheap	light
KohSantepheap-Regular	Koh Santepheap	regular
KohSantepheap-Thin	Koh Santepheap	thin
Kokoro-Regular	NONE	regular
KolkerBrush-Regular	Kolker Brush	regular
KonkhmerSleokchher-Regular	Konkhmer Sleokchher	regular
Kosugi-Regular	Kosugi	regular
KosugiMaru-Regular	Kosugi Maru	regular
KottaOne-Regular	Kotta One	regular
Koulen-Regular	Koulen	regular
Kranky-Regular	Kranky	regular
Kreon[wght]	Kreon	regular
Kristi-Regular	Kristi	regular
KronaOne-Regular	Krona One	regular
Krub-Bold	Krub	bold
Krub-BoldItalic	Krub	bolditalic
Krub-ExtraLight	Krub	extralight
Krub-ExtraLightItalic	Krub	extralightitalic
Krub-Italic	Krub	italic
Krub-Light	Krub	light
Krub-LightItalic	Krub	lightitalic
Krub-Medium	Krub	medium
Krub-MediumItalic	Krub	mediumitalic
Krub-Regular	Krub	regular
Krub-SemiBold	Krub	semibold
Krub-SemiBoldItalic	Krub	semibolditalic
Kufam-Italic[wght]	Kufam	italic
Kufam[wght]	Kufam	regular
KulimPark-Bold	Kulim Park	bold
KulimPark-BoldItalic	Kulim Park	bolditalic
KulimPark-ExtraLight	Kulim Park	extralight
KulimPark-ExtraLightItalic	Kulim Park	extralightitalic
KulimPark-Italic	Kulim Park	italic
KulimPark-Light	Kulim Park	light
KulimPark-LightItalic	Kulim Park	lightitalic
KulimPark-Regular	Kulim Park	regular
KulimPark-SemiBold	Kulim Park	semibold
KulimPark-SemiBoldItalic	Kulim Park	semibolditalic
KumarOne-Regular	Kumar One	regular
KumbhSans[YOPQ,wght]	Kumbh Sans	regular
Kurale-Regular	Kurale	regular
LaBelleAurore	La Belle Aurore	regular
Labrada-Italic[wght]	Labrada	italic
Labrada[wght]	Labrada	regular
Lacquer-Regular	Lacquer	regular
Laila-Bold	Laila	bold
Laila-Light	Laila	light
Laila-Medium	Laila	medium
Laila-Regular	Laila	regular
Laila-SemiBold	Laila	semibold
LakkiReddy-Regular	Lakki Reddy	regular
Lalezar-Regular	Lalezar	regular
Lancelot-Regular	Lancelot	regular
Langar-Regular	Langar	regular
Lateef-Bold	Lateef	bold
Lateef-ExtraBold	Lateef	extrabold
Lateef-ExtraLight	Lateef	extralight
Lateef-Light	Lateef	light
Lateef-Medium	Lateef	medium
Lateef-Regular	Lateef	regular
Lateef-SemiBold	Lateef	semibold
Lato-Black	Lato	black
Lato-BlackItalic	Lato	blackitalic
Lato-Bold	Lato	bold
Lato-BoldItalic	Lato	bolditalic
Lato-ExtraBold	Lato	extrabold
Lato-ExtraBoldItalic	Lato	extrabolditalic
Lato-ExtraLight	Lato	extralight
Lato-ExtraLightItalic	Lato	extralightitalic
Lato-Italic	Lato	italic
Lato-Light	Lato	light
Lato-LightItalic	Lato	lightitalic
Lato-Medium	Lato	medium
Lato-MediumItalic	Lato	mediumitalic
Lato-Regular	Lato	regular
Lato-SemiBold	Lato	semibold
Lato-SemiBoldItalic	Lato	semibolditalic
Lato-Thin	Lato	thin
Lato-ThinItalic	Lato	thinitalic
LavishlyYours-Regular	Lavishly Yours	regular
LeagueGothic[wdth]	League Gothic	regular
LeagueScript-Regular	League Script	regular
LeagueSpartan[wght]	League Spartan	regular
LeckerliOne-Regular	Leckerli One	regular
Ledger-Regular	Ledger	regular
Lekton-Bold	Lekton	bold
Lekton-Italic	Lekton	italic
Lekton-Regular	Lekton	regular
Lemon-Regular	Lemon	regular
LemonadaVFBeta	NONE	regular
Lemonada[wght]	Lemonada	regular
LexendDeca[wght]	Lexend Deca	regular
LexendExa[wght]	Lexend Exa	regular
LexendGiga[wght]	Lexend Giga	regular
LexendMega[wght]	Lexend Mega	regular
LexendPeta[wght]	Lexend Peta	regular
LexendTera[wght]	Lexend Tera	regular
LexendZetta[wght]	Lexend Zetta	regular
Lexend[wght]	Lexend	regular
LibreBarcode128-Regular	Libre Barcode 128	regular
LibreBarcode128Text-Regular	Libre Barcode 128 Text	regular
LibreBarcode39-Regular	Libre Barcode 39	regular
LibreBarcode39Extended-Regular	Libre Barcode 39 Extended	regular
LibreBarcode39ExtendedText-Regular	Libre Barcode 39 Extended Text	regular
LibreBarcode39Text-Regular	Libre Barcode 39 Text	regular
LibreBarcodeEAN13Text-Regular	Libre Barcode EAN13 Text	regular
LibreBaskerville-Bold	Libre Baskerville	bold
LibreBaskerville-Italic	Libre Baskerville	italic
LibreBaskerville-Regular	Libre Baskerville	regular
LibreBodoni-Italic[wght]	Libre Bodoni	italic
LibreBodoni[wght]	Libre Bodoni	regular
LibreCaslonDisplay-Regular	Libre Caslon Display	regular
LibreCaslonText-Italic[wght]	Libre Caslon Text	italic
LibreCaslonText[wght]	Libre Caslon Text	regular
LibreFranklin-Italic[wght]	Libre Franklin	italic
LibreFranklin[wght]	Libre Franklin	regular
Licorice-Regular	Licorice	regular
LifeSavers-Bold	Life Savers	bold
LifeSavers-ExtraBold	Life Savers	extrabold
LifeSavers-Regular	Life Savers	regular
LilitaOne-Regular	Lilita One	regular
LilyScriptOne-Regular	Lily Script One	regular
Limelight-Regular	Limelight	regular
LindenHill-Italic	Linden Hill	italic
LindenHill-Regular	Linden Hill	regular
Linefont[wdth,wght]	Linefont	regular
LisuBosa-Black	Lisu Bosa	black
LisuBosa-BlackItalic	Lisu Bosa	blackitalic
LisuBosa-Bold	Lisu Bosa	bold
LisuBosa-BoldItalic	Lisu Bosa	bolditalic
LisuBosa-ExtraBold	Lisu Bosa	extrabold
LisuBosa-ExtraBoldItalic	Lisu Bosa	extrabolditalic
LisuBosa-ExtraLight	Lisu Bosa	extralight
LisuBosa-ExtraLightItalic	Lisu Bosa	extralightitalic
LisuBosa-Italic	Lisu Bosa	italic
LisuBosa-Light	Lisu Bosa	light
LisuBosa-LightItalic	Lisu Bosa	lightitalic
LisuBosa-Medium	Lisu Bosa	medium
LisuBosa-MediumItalic	Lisu Bosa	mediumitalic
LisuBosa-Regular	Lisu Bosa	regular
LisuBosa-SemiBold	Lisu Bosa	semibold
LisuBosa-SemiBoldItalic	Lisu Bosa	semibolditalic
Literata-Italic[opsz,wght]	Literata	italic
Literata[opsz,wght]	Literata	regular
LiuJianMaoCao-Regular	Liu Jian Mao Cao	regular
Livvic-Black	Livvic	black
Livvic-BlackItalic	Livvic	blackitalic
Livvic-Bold	Livvic	bold
Livvic-BoldItalic	Livvic	bolditalic
Livvic-ExtraLight	Livvic	extralight
Livvic-ExtraLightItalic	Livvic	extralightitalic
Livvic-Italic	Livvic	italic
Livvic-Light	Livvic	light
Livvic-LightItalic	Livvic	lightitalic
Livvic-Medium	Livvic	medium
Livvic-MediumItalic	Livvic	mediumitalic
Livvic-Regular	Livvic	regular
Livvic-SemiBold	Livvic	semibold
Livvic-SemiBoldItalic	Livvic	semibolditalic
Livvic-Thin	Livvic	thin
Livvic-ThinItalic	Livvic	thinitalic
Lobster-Regular	Lobster	regular
LobsterTwo-Bold	Lobster Two	bold
LobsterTwo-BoldItalic	Lobster Two	bolditalic
LobsterTwo-Italic	Lobster Two	italic
LobsterTwo-Regular	Lobster Two	regular
Lohit-Bengali	NONE	bengali
Lohit-Devanagari	NONE	devanagari
Lohit-Tamil	NONE	tamil
LondrinaOutline-Regular	Londrina Outline	regular
LondrinaShadow-Regular	Londrina Shadow	regular
LondrinaSketch-Regular	Londrina Sketch	regular
LondrinaSolid-Black	Londrina Solid	black
LondrinaSolid-Light	Londrina Solid	light
LondrinaSolid-Regular	Londrina Solid	regular
LondrinaSolid-Thin	Londrina Solid	thin
LongCang-Regular	Long Cang	regular
Lora-Italic[wght]	Lora	italic
Lora[wght]	Lora	regular
LoveLight-Regular	Love Light	regular
LoveYaLikeASister	Love Ya Like A Sister	regular
LovedbytheKing	Loved by the King	regular
LoversQuarrel-Regular	Lovers Quarrel	regular
LuckiestGuy-Regular	Luckiest Guy	regular
Lugrasimo-Regular	Lugrasimo	regular
Lumanosimo-Regular	Lumanosimo	regular
Lunasima-Bold	Lunasima	bold
Lunasima-Regular	Lunasima	regular
Lusitana-Bold	Lusitana	bold
Lusitana-Regular	Lusitana	regular
Lustria-Regular	Lustria	regular
LuxuriousRoman-Regular	Luxurious Roman	regular
LuxuriousScript-Regular	Luxurious Script	regular
MPLUS1Code[wght]	M PLUS 1 Code	regular
MPLUS1[wght]	M PLUS 1	regular
MPLUS1p-Black	M PLUS 1p	black
MPLUS1p-Bold	M PLUS 1p	bold
MPLUS1p-ExtraBold	M PLUS 1p	extrabold
MPLUS1p-Light	M PLUS 1p	light
MPLUS1p-Medium	M PLUS 1p	medium
MPLUS1p-Regular	M PLUS 1p	regular
MPLUS1p-Thin	M PLUS 1p	thin
MPLUS2[wght]	M PLUS 2	regular
MPLUSCodeLatin[wdth,wght]	M PLUS Code Latin	regular
MaShanZheng-Regular	Ma Shan Zheng	regular
Macondo-Regular	Macondo	regular
MacondoSwashCaps-Regular	Macondo Swash Caps	regular
Mada[wght]	Mada	regular
Magra-Bold	Magra	bold
Magra-Regular	Magra	regular
MaidenOrange-Regular	Maiden Orange	regular
Maitree-Bold	Maitree	bold
Maitree-ExtraLight	Maitree	extralight
Maitree-Light	Maitree	light
Maitree-Medium	Maitree	medium
Maitree-Regular	Maitree	regular
Maitree-SemiBold	Maitree	semibold
MajorMonoDisplay-Regular	Major Mono Display	regular
Mako-Regular	Mako	regular
Mali-Bold	Mali	bold
Mali-BoldItalic	Mali	bolditalic
Mali-ExtraLight	Mali	extralight
Mali-ExtraLightItalic	Mali	extralightitalic
Mali-Italic	Mali	italic
Mali-Light	Mali	light
Mali-LightItalic	Mali	lightitalic
Mali-Medium	Mali	medium
Mali-MediumItalic	Mali	mediumitalic
Mali-Regular	Mali	regular
Mali-SemiBold	Mali	semibold
Mali-SemiBoldItalic	Mali	semibolditalic
Mallanna-Regular	Mallanna	regular
Mandali-Regular	Mandali	regular
Manjari-Bold	Manjari	bold
Manjari-Regular	Manjari	regular
Manjari-Thin	Manjari	thin
Manrope[wght]	Manrope	regular
Mansalva-Regular	Mansalva	regular
Manuale-Italic[wght]	Manuale	italic
Manuale[wght]	Manuale	regular
Marcellus-Regular	Marcellus	regular
MarcellusSC-Regular	Marcellus SC	regular
MarckScript-Regular	Marck Script	regular
Margarine-Regular	Margarine	regular
Marhey[wght]	Marhey	regular
MarkaziText-VF	NONE	regular
MarkaziText[wght]	Markazi Text	regular
MarkoOne-Regular	Marko One	regular
Marmelad-Regular	Marmelad	regular
Martel-Bold	Martel	bold
Martel-DemiBold	Martel	demibold
Martel-ExtraBold	Martel	extrabold
Martel-Heavy	Martel	heavy
Martel-Light	Martel	light
Martel-Regular	Martel	regular
Martel-UltraLight	Martel	ultralight
MartelSans-Black	Martel Sans	black
MartelSans-Bold	Martel Sans	bold
MartelSans-ExtraBold	Martel Sans	extrabold
MartelSans-ExtraLight	Martel Sans	extralight
MartelSans-Light	Martel Sans	light
MartelSans-Regular	Martel Sans	regular
MartelSans-SemiBold	Martel Sans	semibold
MartianMono[wdth,wght]	Martian Mono	regular
Marvel-Bold	Marvel	bold
Marvel-BoldItalic	Marvel	bolditalic
Marvel-Italic	Marvel	italic
Marvel-Regular	Marvel	regular
Mate-Italic	Mate	italic
Mate-Regular	Mate	regular
MateSC-Regular	Mate SC	regular
MavenProVFBeta	NONE	regular
MavenPro[wght]	Maven Pro	regular
McLaren-Regular	McLaren	regular
MeaCulpa-Regular	Mea Culpa	regular
Meddon	Meddon	regular
MedievalSharp	MedievalSharp	regular
MedulaOne-Regular	Medula One	regular
MeeraInimai-Regular	Meera Inimai	regular
Megrim	Megrim	regular
MeieScript-Regular	Meie Script	regular
Menlo-Regular	NONE	regular
MeowScript-Regular	Meow Script	regular
MergeOne-Regular	NONE	regular
Merienda[wght]	Merienda	regular
Merriweather-Black	Merriweather	black
Merriweather-BlackItalic	Merriweather	blackitalic
Merriweather-Bold	Merriweather	bold
Merriweather-BoldItalic	Merriweather	bolditalic
Merriweather-Italic	Merriweather	italic
Merriweather-Light	Merriweather	light
Merriweather-LightItalic	Merriweather	lightitalic
Merriweather-Regular	Merriweather	regular
MerriweatherSans-Italic[wght]	Merriweather Sans	italic
MerriweatherSans[wght]	Merriweather Sans	regular
MervaleScript-Regular	NONE	regular
Metal-Regular	Metal	regular
MetalMania-Regular	Metal Mania	regular
Metamorphous-Regular	Metamorphous	regular
Metrophobic-Regular	Metrophobic	regular
Miama-Regular	NONE	regular
Michroma-Regular	Michroma	regular
Milonga-Regular	Milonga	regular
Miltonian-Regular	Miltonian	regular
MiltonianTattoo-Regular	Miltonian Tattoo	regular
Mina-Bold	Mina	bold
Mina-Regular	Mina	regular
Mingzat-Regular	Mingzat	regular
Miniver-Regular	Miniver	regular
MiriamLibre-Bold	Miriam Libre	bold
MiriamLibre-Regular	Miriam Libre	regular
Mirza-Bold	Mirza	bold
Mirza-Medium	Mirza	medium
Mirza-Regular	Mirza	regular
Mirza-SemiBold	Mirza	semibold
MissFajardose-Regular	Miss Fajardose	regular
Mitr-Bold	Mitr	bold
Mitr-ExtraLight	Mitr	extralight
Mitr-Light	Mitr	light
Mitr-Medium	Mitr	medium
Mitr-Regular	Mitr	regular
Mitr-SemiBold	Mitr	semibold
MochiyPopOne-Regular	Mochiy Pop One	regular
MochiyPopPOne-Regular	Mochiy Pop P One	regular
Modak-Regular	Modak	regular
ModernAntiqua-Regular	Modern Antiqua	regular
Mogra-Regular	Mogra	regular
Mohave-Italic[wght]	Mohave	italic
Mohave[wght]	Mohave	regular
MoiraiOne-Regular	Moirai One	regular
Molengo-Regular	Molengo	regular
Molle-Regular	Molle	regular
Monda-Bold	Monda	bold
Monda-Regular	Monda	regular
Monofett-Regular	Monofett	regular
MonomaniacOne-Regular	Monomaniac One	regular
Monoton-Regular	Monoton	regular
MonsieurLaDoulaise-Regular	Monsieur La Doulaise	regular
Montaga-Regular	Montaga	regular
MontaguSlab[opsz,wght]	Montagu Slab	regular
MonteCarlo-Regular	MonteCarlo	regular
Montez-Regular	Montez	regular
Montserrat-Italic[wght]	Montserrat	italic
MontserratAlternates-Black	Montserrat Alternates	black
MontserratAlternates-BlackItalic	Montserrat Alternates	blackitalic
MontserratAlternates-Bold	Montserrat Alternates	bold
MontserratAlternates-BoldItalic	Montserrat Alternates	bolditalic
MontserratAlternates-ExtraBold	Montserrat Alternates	extrabold
MontserratAlternates-ExtraBoldItalic	Montserrat Alternates	extrabolditalic
MontserratAlternates-ExtraLight	Montserrat Alternates	extralight
MontserratAlternates-ExtraLightItalic	Montserrat Alternates	extralightitalic
MontserratAlternates-Italic	Montserrat Alternates	italic
MontserratAlternates-Light	Montserrat Alternates	light
MontserratAlternates-LightItalic	Montserrat Alternates	lightitalic
MontserratAlternates-Medium	Montserrat Alternates	medium
MontserratAlternates-MediumItalic	Montserrat Alternates	mediumitalic
MontserratAlternates-Regular	Montserrat Alternates	regular
MontserratAlternates-SemiBold	Montserrat Alternates	semibold
MontserratAlternates-SemiBoldItalic	Montserrat Alternates	semibolditalic
MontserratAlternates-Thin	Montserrat Alternates	thin
MontserratAlternates-ThinItalic	Montserrat Alternates	thinitalic
MontserratSubrayada-Bold	Montserrat Subrayada	bold
MontserratSubrayada-Regular	Montserrat Subrayada	regular
Montserrat[wght]	Montserrat	regular
MooLahLah-Regular	Moo Lah Lah	regular
Mooli-Regular	Mooli	regular
MoonDance-Regular	Moon Dance	regular
Moul-Regular	Moul	regular
Moulpali-Regular	Moulpali	regular
MountainsofChristmas-Bold	Mountains of Christmas	bold
MountainsofChristmas-Regular	Mountains of Christmas	regular
MouseMemoirs-Regular	Mouse Memoirs	regular
MrBedfort-Regular	Mr Bedfort	regular
MrDafoe-Regular	Mr Dafoe	regular
MrDeHaviland-Regular	Mr De Haviland	regular
MrsSaintDelafield-Regular	Mrs Saint Delafield	regular
MrsSheppards-Regular	Mrs Sheppards	regular
MsMadi-Regular	Ms Madi	regular
Mukta-Bold	Mukta	bold
Mukta-ExtraBold	Mukta	extrabold
Mukta-ExtraLight	Mukta	extralight
Mukta-Light	Mukta	light
Mukta-Medium	Mukta	medium
Mukta-Regular	Mukta	regular
Mukta-SemiBold	Mukta	semibold
MuktaMahee-Bold	Mukta Mahee	bold
MuktaMahee-ExtraBold	Mukta Mahee	extrabold
MuktaMahee-ExtraLight	Mukta Mahee	extralight
MuktaMahee-Light	Mukta Mahee	light
MuktaMahee-Medium	Mukta Mahee	medium
MuktaMahee-Regular	Mukta Mahee	regular
MuktaMahee-SemiBold	Mukta Mahee	semibold
MuktaMalar-Bold	Mukta Malar	bold
MuktaMalar-ExtraBold	Mukta Malar	extrabold
MuktaMalar-ExtraLight	Mukta Malar	extralight
MuktaMalar-Light	Mukta Malar	light
MuktaMalar-Medium	Mukta Malar	medium
MuktaMalar-Regular	Mukta Malar	regular
MuktaMalar-SemiBold	Mukta Malar	semibold
MuktaVaani-Bold	Mukta Vaani	bold
MuktaVaani-ExtraBold	Mukta Vaani	extrabold
MuktaVaani-ExtraLight	Mukta Vaani	extralight
MuktaVaani-Light	Mukta Vaani	light
MuktaVaani-Medium	Mukta Vaani	medium
MuktaVaani-Regular	Mukta Vaani	regular
MuktaVaani-SemiBold	Mukta Vaani	semibold
Mulish-Italic[wght]	Mulish	italic
Mulish[wght]	Mulish	regular
Murecho[wght]	Murecho	regular
MuseoModerno-Italic[wght]	MuseoModerno	italic
MuseoModerno[wght]	MuseoModerno	regular
MySoul-Regular	My Soul	regular
MyanmarSansPro-Regular	NONE	regular
Mynerve-Regular	Mynerve	regular
MysteryQuest-Regular	Mystery Quest	regular
NATS-Regular	NONE	regular
NTR-Regular	NTR	regular
Nabla[EDPT,EHLT]	Nabla	regular
Namdhinggo-Bold	Namdhinggo	bold
Namdhinggo-ExtraBold	Namdhinggo	extrabold
Namdhinggo-Medium	Namdhinggo	medium
Namdhinggo-Regular	Namdhinggo	regular
Namdhinggo-SemiBold	Namdhinggo	semibold
NanumBrushScript-Regular	Nanum Brush Script	regular
NanumGothic-Bold	Nanum Gothic	bold
NanumGothic-ExtraBold	Nanum Gothic	extrabold
NanumGothic-Regular	Nanum Gothic	regular
NanumGothicCoding-Bold	Nanum Gothic Coding	bold
NanumGothicCoding-Regular	Nanum Gothic Coding	regular
NanumMyeongjo-Bold	Nanum Myeongjo	bold
NanumMyeongjo-ExtraBold	Nanum Myeongjo	extrabold
NanumMyeongjo-Regular	Nanum Myeongjo	regular
NanumPenScript-Regular	Nanum Pen Script	regular
Narnoor-Bold	Narnoor	bold
Narnoor-ExtraBold	Narnoor	extrabold
Narnoor-Medium	Narnoor	medium
Narnoor-Regular	Narnoor	regular
Narnoor-SemiBold	Narnoor	semibold
Neonderthaw-Regular	Neonderthaw	regular
NerkoOne-Regular	Nerko One	regular
Neucha	Neucha	regular
Neuton-Bold	Neuton	bold
Neuton-ExtraBold	Neuton	extrabold
Neuton-ExtraLight	Neuton	extralight
Neuton-Italic	Neuton	italic
Neuton-Light	Neuton	light
Neuton-Regular	Neuton	regular
NewRocker-Regular	New Rocker	regular
NewTegomin-Regular	New Tegomin	regular
NewsCycle-Bold	News Cycle	bold
NewsCycle-Regular	News Cycle	regular
Newsreader-Italic[opsz,wght]	Newsreader	italic
Newsreader[opsz,wght]	Newsreader	regular
NicoMoji-Regular	NONE	regular
Niconne-Regular	Niconne	regular
Nikukyu-Regular	NONE	regular
Niramit-Bold	Niramit	bold
Niramit-BoldItalic	Niramit	bolditalic
Niramit-ExtraLight	Niramit	extralight
Niramit-ExtraLightItalic	Niramit	extralightitalic
Niramit-Italic	Niramit	italic
Niramit-Light	Niramit	light
Niramit-LightItalic	Niramit	lightitalic
Niramit-Medium	Niramit	medium
Niramit-MediumItalic	Niramit	mediumitalic
Niramit-Regular	Niramit	regular
Niramit-SemiBold	Niramit	semibold
Niramit-SemiBoldItalic	Niramit	semibolditalic
NixieOne-Regular	Nixie One	regular
Nobile-Bold	Nobile	bold
Nobile-BoldItalic	Nobile	bolditalic
Nobile-Italic	Nobile	italic
Nobile-Medium	Nobile	medium
Nobile-MediumItalic	Nobile	mediumitalic
Nobile-Regular	Nobile	regular
Nokora-Black	Nokora	black
Nokora-Bold	Nokora	bold
Nokora-Light	Nokora	light
Nokora-Regular	Nokora	regular
Nokora-Thin	Nokora	thin
Norican-Regular	Norican	regular
Nosifer-Regular	Nosifer	regular
NosiferCaps-Regular	NONE	regular
Notable-Regular	Notable	regular
NothingYouCouldDo	Nothing You Could Do	regular
NoticiaText-Bold	Noticia Text	bold
NoticiaText-BoldItalic	Noticia Text	bolditalic
NoticiaText-Italic	Noticia Text	italic
NoticiaText-Regular	Noticia Text	regular
NotoColorEmoji-Regular	Noto Color Emoji	regular
NotoColorEmojiCompatTest-Regular	NONE	regular
NotoEmoji[wght]	Noto Emoji	regular
NotoKufiArabic[wght]	Noto Kufi Arabic	regular
NotoMusic-Regular	Noto Music	regular
NotoNaskhArabicUI[wght]	NONE	regular
NotoNaskhArabic[wght]	Noto Naskh Arabic	regular
NotoNastaliqUrdu[wght]	Noto Nastaliq Urdu	regular
NotoRashiHebrew[wght]	Noto Rashi Hebrew	regular
NotoSans-Italic[wdth,wght]	Noto Sans	italic
NotoSansAdlamUnjoined[wght]	Noto Sans Adlam Unjoined	regular
NotoSansAdlam[wght]	Noto Sans Adlam	regular
NotoSansAnatolianHieroglyphs-Regular	Noto Sans Anatolian Hieroglyphs	regular
NotoSansArabicUI[wdth,wght]	Noto Sans Arabic	regular
NotoSansArabic[wdth,wght]	Noto Sans Arabic	regular
NotoSansArmenian[wdth,wght]	Noto Sans Armenian	regular
NotoSansAvestan-Regular	Noto Sans Avestan	regular
NotoSansBalinese[wght]	Noto Sans Balinese	regular
NotoSansBamum[wght]	Noto Sans Bamum	regular
NotoSansBassaVah[wght]	Noto Sans Bassa Vah	regular
NotoSansBatak-Regular	Noto Sans Batak	regular
NotoSansBengaliUI[wdth,wght]	Noto Sans Bengali	regular
NotoSansBengali[wdth,wght]	Noto Sans Bengali	regular
NotoSansBhaiksuki-Regular	Noto Sans Bhaiksuki	regular
NotoSansBrahmi-Regular	Noto Sans Brahmi	regular
NotoSansBuginese-Regular	Noto Sans Buginese	regular
NotoSansBuhid-Regular	Noto Sans Buhid	regular
NotoSansCanadianAboriginal[wght]	Noto Sans Canadian Aboriginal	regular
NotoSansCarian-Regular	Noto Sans Carian	regular
NotoSansCaucasianAlbanian-Regular	Noto Sans Caucasian Albanian	regular
NotoSansChakma-Regular	Noto Sans Chakma	regular
NotoSansCham[wght]	Noto Sans Cham	regular
NotoSansCherokee[wght]	Noto Sans Cherokee	regular
NotoSansChorasmian-Regular	Noto Sans Chorasmian	regular
NotoSansCoptic-Regular	Noto Sans Coptic	regular
NotoSansCuneiform-Regular	Noto Sans Cuneiform	regular
NotoSansCypriot-Regular	Noto Sans Cypriot	regular
NotoSansCyproMinoan-Regular	Noto Sans Cypro Minoan	regular
NotoSansDeseret-Regular	Noto Sans Deseret	regular
NotoSansDevanagariUI-Black	Noto Sans Devanagari	black
NotoSansDevanagariUI-Bold	Noto Sans Devanagari	bold
NotoSansDevanagariUI-ExtraBold	Noto Sans Devanagari	extrabold
NotoSansDevanagariUI-ExtraLight	Noto Sans Devanagari	extralight
NotoSansDevanagariUI-Light	Noto Sans Devanagari	light
NotoSansDevanagariUI-Medium	Noto Sans Devanagari	medium
NotoSansDevanagariUI-Regular	Noto Sans Devanagari	regular
NotoSansDevanagariUI-SemiBold	Noto Sans Devanagari	semibold
NotoSansDevanagariUI-Thin	Noto Sans Devanagari	thin
NotoSansDevanagari[wdth,wght]	Noto Sans Devanagari	regular
NotoSansDisplay-Italic[wdth,wght]	Noto Sans Display	italic
NotoSansDisplay[wdth,wght]	Noto Sans Display	regular
NotoSansDuployan-Bold	Noto Sans Duployan	bold
NotoSansDuployan-Regular	Noto Sans Duployan	regular
NotoSansEgyptianHieroglyphs-Regular	Noto Sans Egyptian Hieroglyphs	regular
NotoSansElbasan-Regular	Noto Sans Elbasan	regular
NotoSansElymaic-Regular	Noto Sans Elymaic	regular
NotoSansEthiopic[wdth,wght]	Noto Sans Ethiopic	regular
NotoSansGeorgian[wdth,wght]	Noto Sans Georgian	regular
NotoSansGlagolitic-Regular	Noto Sans Glagolitic	regular
NotoSansGothic-Regular	Noto Sans Gothic	regular
NotoSansGrantha-Regular	Noto Sans Grantha	regular
NotoSansGujaratiUI-Black	Noto Sans Gujarati	black
NotoSansGujaratiUI-Bold	Noto Sans Gujarati	bold
NotoSansGujaratiUI-ExtraBold	Noto Sans Gujarati	extrabold
NotoSansGujaratiUI-ExtraLight	Noto Sans Gujarati	extralight
NotoSansGujaratiUI-Light	Noto Sans Gujarati	light
NotoSansGujaratiUI-Medium	Noto Sans Gujarati	medium
NotoSansGujaratiUI-Regular	Noto Sans Gujarati	regular
NotoSansGujaratiUI-SemiBold	Noto Sans Gujarati	semibold
NotoSansGujaratiUI-Thin	Noto Sans Gujarati	thin
NotoSansGujarati[wdth,wght]	Noto Sans Gujarati	regular
NotoSansGunjalaGondi[wght]	Noto Sans Gunjala Gondi	regular
NotoSansGurmukhiUI[wdth,wght]	Noto Sans Gurmukhi	regular
NotoSansGurmukhi[wdth,wght]	Noto Sans Gurmukhi	regular
NotoSansHK[wght]	Noto Sans HK	regular
NotoSansHanifiRohingya[wght]	Noto Sans Hanifi Rohingya	regular
NotoSansHanunoo-Regular	Noto Sans Hanunoo	regular
NotoSansHatran-Regular	Noto Sans Hatran	regular
NotoSansHebrew[wdth,wght]	Noto Sans Hebrew	regular
NotoSansImperialAramaic-Regular	Noto Sans Imperial Aramaic	regular
NotoSansIndicSiyaqNumbers-Regular	Noto Sans Indic Siyaq Numbers	regular
NotoSansInscriptionalPahlavi-Regular	Noto Sans Inscriptional Pahlavi	regular
NotoSansInscriptionalParthian-Regular	Noto Sans Inscriptional Parthian	regular
NotoSansJP[wght]	Noto Sans JP	regular
NotoSansJavanese[wght]	Noto Sans Javanese	regular
NotoSansKR[wght]	NONE	regular
NotoSansKaithi-Regular	Noto Sans Kaithi	regular
NotoSansKannadaUI[wdth,wght]	Noto Sans Kannada	regular
NotoSansKannada[wdth,wght]	Noto Sans Kannada	regular
NotoSansKawi[wght]	Noto Sans Kawi	regular
NotoSansKayahLi[wght]	Noto Sans Kayah Li	regular
NotoSansKharoshthi-Regular	Noto Sans Kharoshthi	regular
NotoSansKhmerUI[wdth,wght]	Noto Sans Khmer	regular
NotoSansKhmer[wdth,wght]	Noto Sans Khmer	regular
NotoSansKhojki-Regular	Noto Sans Khojki	regular
NotoSansKhudawadi-Regular	Noto Sans Khudawadi	regular
NotoSansLaoLooped[wdth,wght]	Noto Sans Lao Looped	regular
NotoSansLaoUI[wdth,wght]	Noto Sans Lao	regular
NotoSansLao[wdth,wght]	Noto Sans Lao	regular
NotoSansLepcha-Regular	Noto Sans Lepcha	regular
NotoSansLimbu-Regular	Noto Sans Limbu	regular
NotoSansLinearA-Regular	Noto Sans Linear A	regular
NotoSansLinearB-Regular	Noto Sans Linear B	regular
NotoSansLisu[wght]	Noto Sans Lisu	regular
NotoSansLycian-Regular	Noto Sans Lycian	regular
NotoSansLydian-Regular	Noto Sans Lydian	regular
NotoSansMahajani-Regular	Noto Sans Mahajani	regular
NotoSansMalayalamUI[wdth,wght]	Noto Sans Malayalam	regular
NotoSansMalayalam[wdth,wght]	Noto Sans Malayalam	regular
NotoSansMandaic-Regular	Noto Sans Mandaic	regular
NotoSansManichaean-Regular	Noto Sans Manichaean	regular
NotoSansMarchen-Regular	Noto Sans Marchen	regular
NotoSansMasaramGondi-Regular	Noto Sans Masaram Gondi	regular
NotoSansMath-Regular	Noto Sans Math	regular
NotoSansMayanNumerals-Regular	Noto Sans Mayan Numerals	regular
NotoSansMedefaidrin[wght]	Noto Sans Medefaidrin	regular
NotoSansMeeteiMayek[wght]	Noto Sans Meetei Mayek	regular
NotoSansMendeKikakui-Regular	Noto Sans Mende Kikakui	regular
NotoSansMeroitic-Regular	Noto Sans Meroitic	regular
NotoSansMiao-Regular	Noto Sans Miao	regular
NotoSansModi-Regular	Noto Sans Modi	regular
NotoSansMongolian-Regular	Noto Sans Mongolian	regular
NotoSansMono[wdth,wght]	Noto Sans Mono	regular
NotoSansMro-Regular	Noto Sans Mro	regular
NotoSansMultani-Regular	Noto Sans Multani	regular
NotoSansMyanmarUI-Black	Noto Sans Myanmar	black
NotoSansMyanmarUI-Bold	Noto Sans Myanmar	bold
NotoSansMyanmarUI-ExtraBold	Noto Sans Myanmar	extrabold
NotoSansMyanmarUI-ExtraLight	Noto Sans Myanmar	extralight
NotoSansMyanmarUI-Light	Noto Sans Myanmar	light
NotoSansMyanmarUI-Medium	Noto Sans Myanmar	medium
NotoSansMyanmarUI-Regular	Noto Sans Myanmar	regular
NotoSansMyanmarUI-SemiBold	Noto Sans Myanmar	semibold
NotoSansMyanmarUI-Thin	Noto Sans Myanmar	thin
NotoSansMyanmar[wdth,wght]	Noto Sans Myanmar	regular
NotoSansNKo-Regular	Noto Sans NKo	regular
NotoSansNKoUnjoined[wght]	Noto Sans NKo Unjoined	regular
NotoSansNabataean-Regular	Noto Sans Nabataean	regular
NotoSansNagMundari[wght]	Noto Sans Nag Mundari	regular
NotoSansNandinagari-Regular	Noto Sans Nandinagari	regular
NotoSansNewTaiLue[wght]	Noto Sans New Tai Lue	regular
NotoSansNewa-Regular	Noto Sans Newa	regular
NotoSansNushu-Regular	Noto Sans Nushu	regular
NotoSansOgham-Regular	Noto Sans Ogham	regular
NotoSansOlChiki[wght]	Noto Sans Ol Chiki	regular
NotoSansOldHungarian-Regular	Noto Sans Old Hungarian	regular
NotoSansOldItalic-Regular	Noto Sans Old Italic	regular
NotoSansOldNorthArabian-Regular	Noto Sans Old North Arabian	regular
NotoSansOldPermic-Regular	Noto Sans Old Permic	regular
NotoSansOldPersian-Regular	Noto Sans Old Persian	regular
NotoSansOldSogdian-Regular	Noto Sans Old Sogdian	regular
NotoSansOldSouthArabian-Regular	Noto Sans Old South Arabian	regular
NotoSansOldTurkic-Regular	Noto Sans Old Turkic	regular
NotoSansOriyaUI-Black	Noto Sans Oriya	black
NotoSansOriyaUI-Bold	Noto Sans Oriya	bold
NotoSansOriyaUI-Regular	Noto Sans Oriya	regular
NotoSansOriyaUI-Thin	Noto Sans Oriya	thin
NotoSansOriya[wdth,wght]	Noto Sans Oriya	regular
NotoSansOsage-Regular	Noto Sans Osage	regular
NotoSansOsmanya-Regular	Noto Sans Osmanya	regular
NotoSansPahawhHmong-Regular	Noto Sans Pahawh Hmong	regular
NotoSansPalmyrene-Regular	Noto Sans Palmyrene	regular
NotoSansPauCinHau-Regular	Noto Sans Pau Cin Hau	regular
NotoSansPhagsPa-Regular	Noto Sans Phags Pa	regular
NotoSansPhoenician-Regular	Noto Sans Phoenician	regular
NotoSansPsalterPahlavi-Regular	Noto Sans Psalter Pahlavi	regular
NotoSansRejang-Regular	Noto Sans Rejang	regular
NotoSansRunic-Regular	Noto Sans Runic	regular
NotoSansSC[wght]	Noto Sans SC	regular
NotoSansSamaritan-Regular	Noto Sans Samaritan	regular
NotoSansSaurashtra-Regular	Noto Sans Saurashtra	regular
NotoSansSharada-Regular	Noto Sans Sharada	regular
NotoSansShavian-Regular	Noto Sans Shavian	regular
NotoSansSiddham-Regular	Noto Sans Siddham	regular
NotoSansSignWriting-Regular	Noto Sans SignWriting	regular
NotoSansSinhalaUI[wdth,wght]	Noto Sans Sinhala	regular
NotoSansSinhala[wdth,wght]	Noto Sans Sinhala	regular
NotoSansSogdian-Regular	Noto Sans Sogdian	regular
NotoSansSoraSompeng[wght]	Noto Sans Sora Sompeng	regular
NotoSansSoyombo-Regular	Noto Sans Soyombo	regular
NotoSansSundanese[wght]	Noto Sans Sundanese	regular
NotoSansSylotiNagri-Regular	Noto Sans Syloti Nagri	regular
NotoSansSymbols2-Regular	Noto Sans Symbols 2	regular
NotoSansSymbols[wght]	Noto Sans Symbols	regular
NotoSansSyriacEastern[wght]	Noto Sans Syriac Eastern	regular
NotoSansSyriac[wght]	Noto Sans Syriac	regular
NotoSansTC[wght]	Noto Sans TC	regular
NotoSansTagalog-Regular	Noto Sans Tagalog	regular
NotoSansTagbanwa-Regular	Noto Sans Tagbanwa	regular
NotoSansTaiLe-Regular	Noto Sans Tai Le	regular
NotoSansTaiTham[wght]	Noto Sans Tai Tham	regular
NotoSansTaiViet-Regular	Noto Sans Tai Viet	regular
NotoSansTakri-Regular	Noto Sans Takri	regular
NotoSansTamilSupplement-Regular	Noto Sans Tamil Supplement	regular
NotoSansTamilUI[wdth,wght]	Noto Sans Tamil	regular
NotoSansTamil[wdth,wght]	Noto Sans Tamil	regular
NotoSansTangsa[wght]	Noto Sans Tangsa	regular
NotoSansTeluguUI[wdth,wght]	Noto Sans Telugu	regular
NotoSansTelugu[wdth,wght]	Noto Sans Telugu	regular
NotoSansThaana[wght]	Noto Sans Thaana	regular
NotoSansThaiLooped-Black	Noto Sans Thai Looped	black
NotoSansThaiLooped-Bold	Noto Sans Thai Looped	bold
NotoSansThaiLooped-ExtraBold	Noto Sans Thai Looped	extrabold
NotoSansThaiLooped-ExtraLight	Noto Sans Thai Looped	extralight
NotoSansThaiLooped-Light	Noto Sans Thai Looped	light
NotoSansThaiLooped-Medium	Noto Sans Thai Looped	medium
NotoSansThaiLooped-Regular	Noto Sans Thai Looped	regular
NotoSansThaiLooped-SemiBold	Noto Sans Thai Looped	semibold
NotoSansThaiLooped-Thin	Noto Sans Thai Looped	thin
NotoSansThaiUI[wdth,wght]	Noto Sans Thai	regular
NotoSansThai[wdth,wght]	Noto Sans Thai	regular
NotoSansTifinagh-Regular	Noto Sans Tifinagh	regular
NotoSansTirhuta-Regular	Noto Sans Tirhuta	regular
NotoSansUgaritic-Regular	Noto Sans Ugaritic	regular
NotoSansVai-Regular	Noto Sans Vai	regular
NotoSansVithkuqi[wght]	Noto Sans Vithkuqi	regular
NotoSansWancho-Regular	Noto Sans Wancho	regular
NotoSansWarangCiti-Regular	Noto Sans Warang Citi	regular
NotoSansYi-Regular	Noto Sans Yi	regular
NotoSansZanabazarSquare-Regular	Noto Sans Zanabazar Square	regular
NotoSans[wdth,wght]	Noto Sans	regular
NotoSerif-Italic[wdth,wght]	Noto Serif	italic
NotoSerifAhom-Regular	Noto Serif Ahom	regular
NotoSerifArmenian[wdth,wght]	Noto Serif Armenian	regular
NotoSerifBalinese-Regular	Noto Serif Balinese	regular
NotoSerifBengali[wdth,wght]	Noto Serif Bengali	regular
NotoSerifDevanagari[wdth,wght]	Noto Serif Devanagari	regular
NotoSerifDisplay-Italic[wdth,wght]	Noto Serif Display	italic
NotoSerifDisplay[wdth,wght]	Noto Serif Display	regular
NotoSerifDogra-Regular	Noto Serif Dogra	regular
NotoSerifEthiopic[wdth,wght]	Noto Serif Ethiopic	regular
NotoSerifGeorgian[wdth,wght]	Noto Serif Georgian	regular
NotoSerifGrantha-Regular	Noto Serif Grantha	regular
NotoSerifGujarati[wght]	Noto Serif Gujarati	regular
NotoSerifGurmukhi[wght]	Noto Serif Gurmukhi	regular
NotoSerifHK[wght]	Noto Serif HK	regular
NotoSerifHebrew[wdth,wght]	Noto Serif Hebrew	regular
NotoSerifJP[wght]	Noto Serif JP	regular
NotoSerifKR[wght]	Noto Serif KR	regular
NotoSerifKannada[wght]	Noto Serif Kannada	regular
NotoSerifKhitanSmallScript-Regular	Noto Serif Khitan Small Script	regular
NotoSerifKhmer[wdth,wght]	Noto Serif Khmer	regular
NotoSerifKhojki[wght]	Noto Serif Khojki	regular
NotoSerifLao[wdth,wght]	Noto Serif Lao	regular
NotoSerifMakasar-Regular	Noto Serif Makasar	regular
NotoSerifMalayalam[wght]	Noto Serif Malayalam	regular
NotoSerifMyanmar-Black	Noto Serif Myanmar	black
NotoSerifMyanmar-Bold	Noto Serif Myanmar	bold
NotoSerifMyanmar-ExtraBold	Noto Serif Myanmar	extrabold
NotoSerifMyanmar-ExtraLight	Noto Serif Myanmar	extralight
NotoSerifMyanmar-Light	Noto Serif Myanmar	light
NotoSerifMyanmar-Medium	Noto Serif Myanmar	medium
NotoSerifMyanmar-Regular	Noto Serif Myanmar	regular
NotoSerifMyanmar-SemiBold	Noto Serif Myanmar	semibold
NotoSerifMyanmar-Thin	Noto Serif Myanmar	thin
NotoSerifNPHmong[wght]	Noto Serif NP Hmong	regular
NotoSerifNyiakengPuachueHmong[wght]	Noto Serif NP Hmong	regular
NotoSerifOldUyghur-Regular	Noto Serif Old Uyghur	regular
NotoSerifOriya[wght]	Noto Serif Oriya	regular
NotoSerifOttomanSiyaq-Regular	Noto Serif Ottoman Siyaq	regular
NotoSerifSC[wght]	Noto Serif SC	regular
NotoSerifSinhala[wdth,wght]	Noto Serif Sinhala	regular
NotoSerifTC[wght]	Noto Serif TC	regular
NotoSerifTamil-Italic[wdth,wght]	Noto Serif Tamil	italic
NotoSerifTamil[wdth,wght]	Noto Serif Tamil	regular
NotoSerifTangut-Regular	Noto Serif Tangut	regular
NotoSerifTelugu[wght]	Noto Serif Telugu	regular
NotoSerifThai[wdth,wght]	Noto Serif Thai	regular
NotoSerifTibetan[wght]	Noto Serif Tibetan	regular
NotoSerifToto[wght]	Noto Serif Toto	regular
NotoSerifVithkuqi[wght]	Noto Serif Vithkuqi	regular
NotoSerifYezidi[wght]	Noto Serif Yezidi	regular
NotoSerif[wdth,wght]	Noto Serif	regular
NotoTraditionalNushu[wght]	Noto Traditional Nushu	regular
NovaCut	Nova Cut	regular
NovaFlat	Nova Flat	regular
NovaMono	Nova Mono	regular
NovaOval	Nova Oval	regular
NovaRound	Nova Round	regular
NovaScript-Regular	Nova Script	regular
NovaSlim	Nova Slim	regular
NovaSquare	Nova Square	regular
Numans-Regular	Numans	regular
Nunito-Italic[wght]	Nunito	italic
NunitoSans-Italic[YTLC,opsz,wdth,wght]	Nunito Sans	italic
NunitoSans[YTLC,opsz,wdth,wght]	Nunito Sans	regular
Nunito[wght]	Nunito	regular
NuosuSIL-Regular	Nuosu SIL	regular
OFLGoudyStMTT-Italic	NONE	italic
OFLGoudyStMTT	NONE	regular
OdibeeSans-Regular	Odibee Sans	regular
OdorMeanChey-Regular	Odor Mean Chey	regular
Offside-Regular	Offside	regular
Oi-Regular	Oi	regular
OldStandard-Bold	Old Standard TT	bold
OldStandard-Italic	Old Standard TT	italic
OldStandard-Regular	Old Standard TT	regular
Oldenburg-Regular	Oldenburg	regular
Ole-Regular	Ole	regular
OleoScript-Bold	Oleo Script	bold
OleoScript-Regular	Oleo Script	regular
OleoScriptSwashCaps-Bold	Oleo Script Swash Caps	bold
OleoScriptSwashCaps-Regular	Oleo Script Swash Caps	regular
Onest[wght]	Onest	regular
OoohBaby-Regular	Oooh Baby	regular
OpenSans-Italic[wdth,wght]	Open Sans	italic
OpenSansHebrew-Bold	NONE	bold
OpenSansHebrew-BoldItalic	NONE	bolditalic
OpenSansHebrew-ExtraBold	NONE	extrabold
OpenSansHebrew-ExtraBoldItalic	NONE	extrabolditalic
OpenSansHebrew-Italic	NONE	italic
OpenSansHebrew-Light	NONE	light
OpenSansHebrew-LightItalic	NONE	lightitalic
OpenSansHebrew-Regular	NONE	regular
OpenSansHebrewCondensed-Bold	NONE Condensed	bold
OpenSansHebrewCondensed-BoldItalic	NONE Condensed	bolditalic
OpenSansHebrewCondensed-ExtraBold	NONE Condensed	extrabold
OpenSansHebrewCondensed-ExtraBoldItalic	NONE Condensed	extrabolditalic
OpenSansHebrewCondensed-Italic	NONE Condensed	italic
OpenSansHebrewCondensed-Light	NONE Condensed	light
OpenSansHebrewCondensed-LightItalic	NONE Condensed	lightitalic
OpenSansHebrewCondensed-Regular	NONE Condensed	regular
OpenSans[wdth,wght]	Open Sans	regular
Oranienbaum-Regular	Oranienbaum	regular
Orbit-Regular	Orbit	regular
Orbitron[wght]	Orbitron	regular
Oregano-Italic	Oregano	italic
Oregano-Regular	Oregano	regular
OrelegaOne-Regular	Orelega One	regular
Orienta-Regular	Orienta	regular
OriginalSurfer-Regular	Original Surfer	regular
Oswald[wght]	Oswald	regular
OtomanopeeOne-Regular	NONE	regular
Outfit[wght]	Outfit	regular
Overlock-Black	Overlock	black
Overlock-BlackItalic	Overlock	blackitalic
Overlock-Bold	Overlock	bold
Overlock-BoldItalic	Overlock	bolditalic
Overlock-Italic	Overlock	italic
Overlock-Regular	Overlock	regular
OverlockSC-Regular	Overlock SC	regular
Overpass-Italic[wght]	Overpass	italic
OverpassMono[wght]	Overpass Mono	regular
Overpass[wght]	Overpass	regular
OvertheRainbow	Over the Rainbow	regular
Ovo-Regular	Ovo	regular
Oxanium[wght]	Oxanium	regular
Oxygen-Bold	Oxygen	bold
Oxygen-Light	Oxygen	light
Oxygen-Regular	Oxygen	regular
OxygenMono-Regular	Oxygen Mono	regular
PTM55FT	NONE	regular
PT_Sans-Caption-Web-Bold	PT Sans Caption	bold
PT_Sans-Caption-Web-Regular	PT Sans Caption	regular
PT_Sans-Narrow-Web-Bold	PT Sans Narrow	narrow
PT_Sans-Narrow-Web-Regular	PT Sans Narrow	narrow
PT_Sans-Web-Bold	PT Sans	bold
PT_Sans-Web-BoldItalic	PT Sans	bolditalic
PT_Sans-Web-Italic	PT Sans	italic
PT_Sans-Web-Regular	PT Sans	regular
PT_Serif-Caption-Web-Italic	PT Serif Caption	italic
PT_Serif-Caption-Web-Regular	PT Serif Caption	regular
PT_Serif-Web-Bold	PT Serif	bold
PT_Serif-Web-BoldItalic	PT Serif	bolditalic
PT_Serif-Web-Italic	PT Serif	italic
PT_Serif-Web-Regular	PT Serif	regular
Pacifico-Regular	Pacifico	regular
Padauk-Bold	Padauk	bold
Padauk-Regular	Padauk	regular
PadyakkeExpandedOne-Regular	Padyakke Expanded One	regular
Palanquin-Bold	Palanquin	bold
Palanquin-ExtraLight	Palanquin	extralight
Palanquin-Light	Palanquin	light
Palanquin-Medium	Palanquin	medium
Palanquin-Regular	Palanquin	regular
Palanquin-SemiBold	Palanquin	semibold
Palanquin-Thin	Palanquin	thin
PalanquinDark-Bold	Palanquin Dark	bold
PalanquinDark-Medium	Palanquin Dark	medium
PalanquinDark-Regular	Palanquin Dark	regular
PalanquinDark-SemiBold	Palanquin Dark	semibold
Palatino Normal	NONE	regular
PaletteMosaic-Regular	Palette Mosaic	regular
Pangolin-Regular	Pangolin	regular
Paprika-Regular	Paprika	regular
Parisienne-Regular	Parisienne	regular
PasseroOne-Regular	Passero One	regular
PassionOne-Black	Passion One	black
PassionOne-Bold	Passion One	bold
PassionOne-Regular	Passion One	regular
PassionsConflict-Regular	Passions Conflict	regular
PathwayExtreme-Italic[opsz,wdth,wght]	Pathway Extreme	italic
PathwayExtreme[opsz,wdth,wght]	Pathway Extreme	regular
PathwayGothicOne-Regular	Pathway Gothic One	regular
PatrickHand-Regular	Patrick Hand	regular
PatrickHandSC-Regular	Patrick Hand SC	regular
Pattaya-Regular	Pattaya	regular
PatuaOne-Regular	Patua One	regular
Pavanam-Regular	Pavanam	regular
PaytoneOne-Regular	Paytone One	regular
Peddana-Regular	Peddana	regular
Peralta-Regular	Peralta	regular
PermanentMarker-Regular	Permanent Marker	regular
Petemoss-Regular	Petemoss	regular
PetitFormalScript-Regular	Petit Formal Script	regular
Petrona-Italic[wght]	Petrona	italic
Petrona[wght]	Petrona	regular
Phetsarath-Bold	NONE	bold
Phetsarath-Regular	NONE	regular
Philosopher-Bold	Philosopher	bold
Philosopher-BoldItalic	Philosopher	bolditalic
Philosopher-Italic	Philosopher	italic
Philosopher-Regular	Philosopher	regular
Phudu[wght]	Phudu	regular
Piazzolla-Italic[opsz,wght]	Piazzolla	italic
Piazzolla[opsz,wght]	Piazzolla	regular
Piedra-Regular	Piedra	regular
PinyonScript-Regular	Pinyon Script	regular
PirataOne-Regular	Pirata One	regular
PixelifySans[wght]	Pixelify Sans	regular
Plaster-Regular	Plaster	regular
Play-Bold	Play	bold
Play-Regular	Play	regular
Playball-Regular	Playball	regular
Playfair-Italic[opsz,wdth,wght]	Playfair	italic
PlayfairDisplay-Italic[wght]	Playfair Display	italic
PlayfairDisplaySC-Black	Playfair Display SC	black
PlayfairDisplaySC-BlackItalic	Playfair Display SC	blackitalic
PlayfairDisplaySC-Bold	Playfair Display SC	bold
PlayfairDisplaySC-BoldItalic	Playfair Display SC	bolditalic
PlayfairDisplaySC-Italic	Playfair Display SC	italic
PlayfairDisplaySC-Regular	Playfair Display SC	regular
PlayfairDisplay[wght]	Playfair Display	regular
Playfair[opsz,wdth,wght]	Playfair	regular
PlaypenSans[wght]	Playpen Sans	regular
PlusJakartaSans-Italic[wght]	Plus Jakarta Sans	italic
PlusJakartaSans[wght]	Plus Jakarta Sans	regular
PodkovaVFBeta	Podkova	regular
Podkova[wght]	Podkova	regular
PoetsenOne-Regular	NONE	regular
PoiretOne-Regular	Poiret One	regular
PollerOne	Poller One	regular
PoltawskiNowy-Italic[wght]	Poltawski Nowy	italic
PoltawskiNowy[wght]	Poltawski Nowy	regular
Poly-Italic	Poly	italic
Poly-Regular	Poly	regular
Pompiere-Regular	Pompiere	regular
Ponnala-Regular	NONE	regular
PontanoSans[wght]	Pontano Sans	regular
PoorStory-Regular	Poor Story	regular
Poppins-Black	Poppins	black
Poppins-BlackItalic	Poppins	blackitalic
Poppins-Bold	Poppins	bold
Poppins-BoldItalic	Poppins	bolditalic
Poppins-ExtraBold	Poppins	extrabold
Poppins-ExtraBoldItalic	Poppins	extrabolditalic
Poppins-ExtraLight	Poppins	extralight
Poppins-ExtraLightItalic	Poppins	extralightitalic
Poppins-Italic	Poppins	italic
Poppins-Light	Poppins	light
Poppins-LightItalic	Poppins	lightitalic
Poppins-Medium	Poppins	medium
Poppins-MediumItalic	Poppins	mediumitalic
Poppins-Regular	Poppins	regular
Poppins-SemiBold	Poppins	semibold
Poppins-SemiBoldItalic	Poppins	semibolditalic
Poppins-Thin	Poppins	thin
Poppins-ThinItalic	Poppins	thinitalic
PortLligatSans-Regular	Port Lligat Sans	regular
PortLligatSlab-Regular	Port Lligat Slab	regular
PorterSansBlock-Regular	NONE	regular
PostNoBillsColombo-Bold	NONE	bold
PostNoBillsColombo-ExtraBold	NONE	extrabold
PostNoBillsColombo-Light	NONE	light
PostNoBillsColombo-Medium	NONE	medium
PostNoBillsColombo-Regular	NONE	regular
PostNoBillsColombo-SemiBold	NONE	semibold
PostNoBillsJaffna-Bold	NONE	bold
PostNoBillsJaffna-ExtraBold	NONE	extrabold
PostNoBillsJaffna-Light	NONE	light
PostNoBillsJaffna-Medium	NONE	medium
PostNoBillsJaffna-Regular	NONE	regular
PostNoBillsJaffna-SemiBold	NONE	semibold
PottaOne-Regular	Potta One	regular
PragatiNarrow-Bold	Pragati Narrow	bold
PragatiNarrow-Regular	Pragati Narrow	regular
Praise-Regular	Praise	regular
Prata-Regular	Prata	regular
Preahvihear-Regular	Preahvihear	regular
PressStart2P-Regular	Press Start 2P	regular
Pridi-Bold	Pridi	bold
Pridi-ExtraLight	Pridi	extralight
Pridi-Light	Pridi	light
Pridi-Medium	Pridi	medium
Pridi-Regular	Pridi	regular
Pridi-SemiBold	Pridi	semibold
PrincessSofia-Regular	Princess Sofia	regular
Prociono-Regular	Prociono	regular
Prompt-Black	Prompt	black
Prompt-BlackItalic	Prompt	blackitalic
Prompt-Bold	Prompt	bold
Prompt-BoldItalic	Prompt	bolditalic
Prompt-ExtraBold	Prompt	extrabold
Prompt-ExtraBoldItalic	Prompt	extrabolditalic
Prompt-ExtraLight	Prompt	extralight
Prompt-ExtraLightItalic	Prompt	extralightitalic
Prompt-Italic	Prompt	italic
Prompt-Light	Prompt	light
Prompt-LightItalic	Prompt	lightitalic
Prompt-Medium	Prompt	medium
Prompt-MediumItalic	Prompt	mediumitalic
Prompt-Regular	Prompt	regular
Prompt-SemiBold	Prompt	semibold
Prompt-SemiBoldItalic	Prompt	semibolditalic
Prompt-Thin	Prompt	thin
Prompt-ThinItalic	Prompt	thinitalic
ProstoOne-Regular	Prosto One	regular
ProzaLibre-Bold	Proza Libre	bold
ProzaLibre-BoldItalic	Proza Libre	bolditalic
ProzaLibre-ExtraBold	Proza Libre	extrabold
ProzaLibre-ExtraBoldItalic	Proza Libre	extrabolditalic
ProzaLibre-Italic	Proza Libre	italic
ProzaLibre-Medium	Proza Libre	medium
ProzaLibre-MediumItalic	Proza Libre	mediumitalic
ProzaLibre-Regular	Proza Libre	regular
ProzaLibre-SemiBold	Proza Libre	semibold
ProzaLibre-SemiBoldItalic	Proza Libre	semibolditalic
PublicSans-Italic[wght]	Public Sans	italic
PublicSans[wght]	Public Sans	regular
PuppiesPlay-Regular	Puppies Play	regular
Puritan-Bold	Puritan	bold
Puritan-BoldItalic	Puritan	bolditalic
Puritan-Italic	Puritan	italic
Puritan-Regular	Puritan	regular
PurplePurse-Regular	Purple Purse	regular
Pushster-Regular	NONE	regular
Qahiri-Regular	Qahiri	regular
Quando-Regular	Quando	regular
Quantico-Bold	Quantico	bold
Quantico-BoldItalic	Quantico	bolditalic
Quantico-Italic	Quantico	italic
Quantico-Regular	Quantico	regular
Quattrocento-Bold	Quattrocento	bold
Quattrocento-Regular	Quattrocento	regular
QuattrocentoSans-Bold	Quattrocento Sans	bold
QuattrocentoSans-BoldItalic	Quattrocento Sans	bolditalic
QuattrocentoSans-Italic	Quattrocento Sans	italic
QuattrocentoSans-Regular	Quattrocento Sans	regular
Questrial-Regular	Questrial	regular
Quicksand[wght]	Quicksand	regular
Quintessential-Regular	Quintessential	regular
Qwigley-Regular	Qwigley	regular
QwitcherGrypen-Bold	Qwitcher Grypen	bold
QwitcherGrypen-Regular	Qwitcher Grypen	regular
REM-Italic[wght]	REM	italic
REM[wght]	REM	regular
RacingSansOne-Regular	Racing Sans One	regular
RadioCanada-Italic[wdth,wght]	Radio Canada	italic
RadioCanada[wdth,wght]	Radio Canada	regular
Radley-Italic	Radley	italic
Radley-Regular	Radley	regular
Rajdhani-Bold	Rajdhani	bold
Rajdhani-Light	Rajdhani	light
Rajdhani-Medium	Rajdhani	medium
Rajdhani-Regular	Rajdhani	regular
Rajdhani-SemiBold	Rajdhani	semibold
Rakkas-Regular	Rakkas	regular
Raleway-Italic[wght]	Raleway	italic
RalewayDots-Regular	Raleway Dots	regular
Raleway[wght]	Raleway	regular
Ramabhadra-Regular	Ramabhadra	regular
Ramaraja-Regular	Ramaraja	regular
Rambla-Bold	Rambla	bold
Rambla-BoldItalic	Rambla	bolditalic
Rambla-Italic	Rambla	italic
Rambla-Regular	Rambla	regular
RammettoOne-Regular	Rammetto One	regular
RampartOne-Regular	Rampart One	regular
Ranchers-Regular	Ranchers	regular
Rancho-Regular	Rancho	regular
Ranga-Bold	Ranga	bold
Ranga-Regular	Ranga	regular
Rasa-Italic[wght]	Rasa	italic
Rasa[wght]	Rasa	regular
Rationale-Regular	Rationale	regular
RaviPrakash-Regular	Ravi Prakash	regular
ReadexPro[HEXP,wght]	Readex Pro	regular
Recursive[CASL,CRSV,MONO,slnt,wght]	Recursive	regular
RedHatDisplay-Italic[wght]	Red Hat Display	italic
RedHatDisplay[wght]	Red Hat Display	regular
RedHatMono-Italic[wght]	Red Hat Mono	italic
RedHatMono[wght]	Red Hat Mono	regular
RedHatText-Italic[wght]	Red Hat Text	italic
RedHatText[wght]	Red Hat Text	regular
RedRose[wght]	Red Rose	regular
Redacted-Regular	Redacted	regular
RedactedScript-Bold	Redacted Script	bold
RedactedScript-Light	Redacted Script	light
RedactedScript-Regular	Redacted Script	regular
RedditSans-Bold	NONE	bold
RedditSans-BoldItalic	NONE	bolditalic
RedditSans-ExtraBold	NONE	extrabold
RedditSans-ExtraBoldItalic	NONE	extrabolditalic
RedditSans-Italic	NONE	italic
RedditSans-Light	NONE	light
RedditSans-LightItalic	NONE	lightitalic
RedditSans-Regular	NONE	regular
RedditSans-SemiBold	NONE	semibold
RedditSans-SemiBoldItalic	NONE	semibolditalic
Redressed-Regular	Redressed	regular
ReemKufiFun[wght]	Reem Kufi Fun	regular
ReemKufiInk-Regular	Reem Kufi Ink	regular
ReemKufi[wght]	Reem Kufi	regular
ReenieBeanie	Reenie Beanie	regular
ReggaeOne-Regular	Reggae One	regular
RethinkSans-Italic[wght]	Rethink Sans	italic
RethinkSans[wght]	Rethink Sans	regular
Revalia-Regular	Revalia	regular
RhodiumLibre-Regular	Rhodium Libre	regular
Ribeye-Regular	Ribeye	regular
RibeyeMarrow-Regular	Ribeye Marrow	regular
Righteous-Regular	Righteous	regular
Risque-Regular	Risque	regular
RoadRage-Regular	Road Rage	regular
Roboto-Italic[wdth,wght]	Roboto	italic
RobotoCondensed-Italic[wght]	Roboto Condensed	italic
RobotoCondensed[wght]	Roboto Condensed	regular
RobotoFlex[GRAD,XOPQ,XTRA,YOPQ,YTAS,YTDE,YTFI,YTLC,YTUC,opsz,slnt,wdth,wght]	Roboto Flex	regular
RobotoMono-Italic[wght]	Roboto Mono	italic
RobotoMono[wght]	Roboto Mono	regular
RobotoSerif-Italic[GRAD,opsz,wdth,wght]	Roboto Serif	italic
RobotoSerif[GRAD,opsz,wdth,wght]	Roboto Serif	regular
RobotoSlab[wght]	Roboto Slab	regular
Roboto[wdth,wght]	Roboto	regular
Rochester-Regular	Rochester	regular
Rock3D-Regular	Rock 3D	regular
RockSalt-Regular	Rock Salt	regular
RocknRollOne-Regular	RocknRoll One	regular
Rokkitt-Italic[wght]	Rokkitt	italic
RokkittVFBeta	Rokkitt	regular
Rokkitt[wght]	Rokkitt	regular
Romanesco-Regular	Romanesco	regular
RopaSans-Italic	Ropa Sans	italic
RopaSans-Regular	Ropa Sans	regular
Rosario-Italic[wght]	Rosario	italic
Rosario[wght]	Rosario	regular
Rosarivo-Italic	Rosarivo	italic
Rosarivo-Regular	Rosarivo	regular
RougeScript-Regular	Rouge Script	regular
RoundedMplus1c-Black	M PLUS Rounded 1c	black
RoundedMplus1c-Bold	M PLUS Rounded 1c	bold
RoundedMplus1c-ExtraBold	M PLUS Rounded 1c	extrabold
RoundedMplus1c-Light	M PLUS Rounded 1c	light
RoundedMplus1c-Medium	M PLUS Rounded 1c	medium
RoundedMplus1c-Regular	M PLUS Rounded 1c	regular
RoundedMplus1c-Thin	M PLUS Rounded 1c	thin
Rowdies-Bold	Rowdies	bold
Rowdies-Light	Rowdies	light
Rowdies-Regular	Rowdies	regular
RozhaOne-Regular	Rozha One	regular
Rubik-Italic[wght]	Rubik	italic
Rubik80sFade-Regular	Rubik 80s Fade	regular
RubikBeastly-Regular	Rubik Beastly	regular
RubikBubbles-Regular	Rubik Bubbles	regular
RubikBurned-Regular	Rubik Burned	regular
RubikDirt-Regular	Rubik Dirt	regular
RubikDistressed-Regular	Rubik Distressed	regular
RubikGemstones-Regular	Rubik Gemstones	regular
RubikGlitch-Regular	Rubik Glitch	regular
RubikIso-Regular	Rubik Iso	regular
RubikLines-Regular	Rubik Lines	regular
RubikMarkerHatch-Regular	Rubik Marker Hatch	regular
RubikMaze-Regular	Rubik Maze	regular
RubikMicrobe-Regular	Rubik Microbe	regular
RubikMonoOne-Regular	Rubik Mono One	regular
RubikMoonrocks-Regular	Rubik Moonrocks	regular
RubikOne-Regular	Rubik Mono One	regular
RubikPixels-Regular	Rubik Pixels	regular
RubikPuddles-Regular	Rubik Puddles	regular
RubikSprayPaint-Regular	Rubik Spray Paint	regular
RubikStorm-Regular	Rubik Storm	regular
RubikVinyl-Regular	Rubik Vinyl	regular
RubikWetPaint-Regular	Rubik Wet Paint	regular
Rubik[wght]	Rubik	regular
Ruda[wght]	Ruda	regular
Rufina-Bold	Rufina	bold
Rufina-Regular	Rufina	regular
RugeBoogie-Regular	Ruge Boogie	regular
Ruluko-Regular	Ruluko	regular
RumRaisin-Regular	Rum Raisin	regular
RuslanDisplay	Ruslan Display	regular
RussoOne-Regular	Russo One	regular
Ruthie-Regular	Ruthie	regular
Ruwudu-Bold	Ruwudu	bold
Ruwudu-Medium	Ruwudu	medium
Ruwudu-Regular	Ruwudu	regular
Ruwudu-SemiBold	Ruwudu	semibold
Rye-Regular	Rye	regular
STIXTwoMath-Regular	NONE	regular
STIXTwoText-Italic[wght]	STIX Two Text	italic
STIXTwoText[wght]	STIX Two Text	regular
Sacramento-Regular	Sacramento	regular
Sahitya-Bold	Sahitya	bold
Sahitya-Regular	Sahitya	regular
Sail-Regular	Sail	regular
Saira-Italic[wdth,wght]	Saira	italic
SairaCondensed-Black	Saira Condensed	black
SairaCondensed-Bold	Saira Condensed	bold
SairaCondensed-ExtraBold	Saira Condensed	extrabold
SairaCondensed-ExtraLight	Saira Condensed	extralight
SairaCondensed-Light	Saira Condensed	light
SairaCondensed-Medium	Saira Condensed	medium
SairaCondensed-Regular	Saira Condensed	regular
SairaCondensed-SemiBold	Saira Condensed	semibold
SairaCondensed-Thin	Saira Condensed	thin
SairaExtraCondensed-Black	Saira Extra Condensed	black
SairaExtraCondensed-Bold	Saira Extra Condensed	bold
SairaExtraCondensed-ExtraBold	Saira Extra Condensed	extrabold
SairaExtraCondensed-ExtraLight	Saira Extra Condensed	extralight
SairaExtraCondensed-Light	Saira Extra Condensed	light
SairaExtraCondensed-Medium	Saira Extra Condensed	medium
SairaExtraCondensed-Regular	Saira Extra Condensed	regular
SairaExtraCondensed-SemiBold	Saira Extra Condensed	semibold
SairaExtraCondensed-Thin	Saira Extra Condensed	thin
SairaSemiCondensed-Black	Saira Semi Condensed	black
SairaSemiCondensed-Bold	Saira Semi Condensed	bold
SairaSemiCondensed-ExtraBold	Saira Semi Condensed	extrabold
SairaSemiCondensed-ExtraLight	Saira Semi Condensed	extralight
SairaSemiCondensed-Light	Saira Semi Condensed	light
SairaSemiCondensed-Medium	Saira Semi Condensed	medium
SairaSemiCondensed-Regular	Saira Semi Condensed	regular
SairaSemiCondensed-SemiBold	Saira Semi Condensed	semibold
SairaSemiCondensed-Thin	Saira Semi Condensed	thin
SairaStencilOne-Regular	Saira Stencil One	regular
Saira[wdth,wght]	Saira	regular
Salsa-Regular	Salsa	regular
Sanchez-Italic	Sanchez	italic
Sanchez-Regular	Sanchez	regular
Sancreek-Regular	Sancreek	regular
Sansation-Bold	NONE	bold
Sansation-BoldItalic	NONE	bolditalic
Sansation-Italic	NONE	italic
Sansation-Light	NONE	light
Sansation-LightItalic	NONE	lightitalic
Sansation-Regular	NONE	regular
Sansita-Black	Sansita	black
Sansita-BlackItalic	Sansita	blackitalic
Sansita-Bold	Sansita	bold
Sansita-BoldItalic	Sansita	bolditalic
Sansita-ExtraBold	Sansita	extrabold
Sansita-ExtraBoldItalic	Sansita	extrabolditalic
Sansita-Italic	Sansita	italic
Sansita-Regular	Sansita	regular
SansitaOne-Regular	NONE	regular
SansitaSwashed[wght]	Sansita Swashed	regular
Sarabun-Bold	Sarabun	bold
Sarabun-BoldItalic	Sarabun	bolditalic
Sarabun-ExtraBold	Sarabun	extrabold
Sarabun-ExtraBoldItalic	Sarabun	extrabolditalic
Sarabun-ExtraLight	Sarabun	extralight
Sarabun-ExtraLightItalic	Sarabun	extralightitalic
Sarabun-Italic	Sarabun	italic
Sarabun-Light	Sarabun	light
Sarabun-LightItalic	Sarabun	lightitalic
Sarabun-Medium	Sarabun	medium
Sarabun-MediumItalic	Sarabun	mediumitalic
Sarabun-Regular	Sarabun	regular
Sarabun-SemiBold	Sarabun	semibold
Sarabun-SemiBoldItalic	Sarabun	semibolditalic
Sarabun-Thin	Sarabun	thin
Sarabun-ThinItalic	Sarabun	thinitalic
Sarala-Bold	Sarala	bold
Sarala-Regular	Sarala	regular
Sarina-Regular	Sarina	regular
Sarpanch-Black	Sarpanch	black
Sarpanch-Bold	Sarpanch	bold
Sarpanch-ExtraBold	Sarpanch	extrabold
Sarpanch-Medium	Sarpanch	medium
Sarpanch-Regular	Sarpanch	regular
Sarpanch-SemiBold	Sarpanch	semibold
SassyFrass-Regular	Sassy Frass	regular
Satisfy-Regular	Satisfy	regular
SawarabiGothic-Regular	Sawarabi Gothic	regular
SawarabiMincho-Regular	Sawarabi Mincho	regular
Scada-Bold	Scada	bold
Scada-BoldItalic	Scada	bolditalic
Scada-Italic	Scada	italic
Scada-Regular	Scada	regular
ScheherazadeNew-Bold	Scheherazade New	bold
ScheherazadeNew-Medium	Scheherazade New	medium
ScheherazadeNew-Regular	Scheherazade New	regular
ScheherazadeNew-SemiBold	Scheherazade New	semibold
SchibstedGrotesk-Italic[wght]	Schibsted Grotesk	italic
SchibstedGrotesk[wght]	Schibsted Grotesk	regular
Schoolbell-Regular	Schoolbell	regular
ScopeOne-Regular	Scope One	regular
SeaweedScript-Regular	Seaweed Script	regular
SecularOne-Regular	Secular One	regular
Sedan-Italic	NONE	italic
Sedan-Regular	NONE	regular
SedanSC-Regular	NONE	regular
SedgwickAve-Regular	Sedgwick Ave	regular
SedgwickAveDisplay-Regular	Sedgwick Ave Display	regular
Sen[wght]	Sen	regular
SendFlowers-Regular	Send Flowers	regular
Sevillana-Regular	Sevillana	regular
SeymourOne-Regular	Seymour One	regular
ShadowsIntoLight	Shadows Into Light	regular
ShadowsIntoLightTwo-Regular	Shadows Into Light Two	regular
Shalimar-Regular	Shalimar	regular
ShantellSans-Italic[BNCE,INFM,SPAC,wght]	Shantell Sans	italic
ShantellSans[BNCE,INFM,SPAC,wght]	Shantell Sans	regular
Shanti-Regular	Shanti	regular
Share-Bold	Share	bold
Share-BoldItalic	Share	bolditalic
Share-Italic	Share	italic
Share-Regular	Share	regular
ShareTech-Regular	Share Tech	regular
ShareTechMono-Regular	Share Tech Mono	regular
ShipporiAntique-Regular	Shippori Antique	regular
ShipporiAntiqueB1-Regular	Shippori Antique B1	regular
ShipporiMincho-Bold	Shippori Mincho	bold
ShipporiMincho-ExtraBold	Shippori Mincho	extrabold
ShipporiMincho-Medium	Shippori Mincho	medium
ShipporiMincho-Regular	Shippori Mincho	regular
ShipporiMincho-SemiBold	Shippori Mincho	semibold
ShipporiMinchoB1-Bold	Shippori Mincho B1	bold
ShipporiMinchoB1-ExtraBold	Shippori Mincho B1	extrabold
ShipporiMinchoB1-Medium	Shippori Mincho B1	medium
ShipporiMinchoB1-Regular	Shippori Mincho B1	regular
ShipporiMinchoB1-SemiBold	Shippori Mincho B1	semibold
Shizuru-Regular	Shizuru	regular
Shojumaru-Regular	Shojumaru	regular
ShortStack-Regular	Short Stack	regular
Shrikhand-Regular	Shrikhand	regular
Siemreap	Siemreap	regular
Sigmar-Regular	Sigmar	regular
SigmarOne-Regular	Sigmar One	regular
SignikaNegativeSC-Bold	Signika Negative	bold
SignikaNegativeSC-Light	Signika Negative	light
SignikaNegativeSC-Regular	Signika Negative	regular
SignikaNegativeSC-SemiBold	Signika Negative	semibold
SignikaNegative[wght]	Signika Negative	regular
SignikaSC[wght]	Signika	regular
Signika[GRAD,wght]	Signika	regular
Silkscreen-Bold	Silkscreen	bold
Silkscreen-Regular	Silkscreen	regular
Simonetta-Black	Simonetta	black
Simonetta-BlackItalic	Simonetta	blackitalic
Simonetta-Italic	Simonetta	italic
Simonetta-Regular	Simonetta	regular
SingleDay-Regular	Single Day	regular
Sintony-Bold	Sintony	bold
Sintony-Regular	Sintony	regular
SirinStencil-Regular	Sirin Stencil	regular
Sitara-Bold	NONE	bold
Sitara-BoldItalic	NONE	bolditalic
Sitara-Italic	NONE	italic
Sitara-Regular	NONE	regular
SixCaps	Six Caps	regular
Sixtyfour[BLED,SCAN]	Sixtyfour	regular
Skranji-Bold	Skranji	bold
Skranji-Regular	Skranji	regular
Slabo13px-Regular	Slabo 13px	regular
Slabo27px-Regular	Slabo 27px	regular
Slackey-Regular	Slackey	regular
SlacksideOne-Regular	Slackside One	regular
Smokum-Regular	Smokum	regular
Smooch-Regular	Smooch	regular
SmoochSans[wght]	Smooch Sans	regular
Smythe-Regular	Smythe	regular
Sniglet-ExtraBold	Sniglet	extrabold
Sniglet-Regular	Sniglet	regular
Snippet	Snippet	regular
SnowburstOne-Regular	Snowburst One	regular
SofadiOne-Regular	Sofadi One	regular
Sofia-Regular	Sofia	regular
SofiaSans-Italic[wght]	Sofia Sans	italic
SofiaSansCondensed-Italic[wght]	Sofia Sans Condensed	italic
SofiaSansCondensed[wght]	Sofia Sans Condensed	regular
SofiaSansExtraCondensed-Italic[wght]	Sofia Sans Extra Condensed	italic
SofiaSansExtraCondensed[wght]	Sofia Sans Extra Condensed	regular
SofiaSansSemiCondensed-Italic[wght]	Sofia Sans Semi Condensed	italic
SofiaSansSemiCondensed[wght]	Sofia Sans Semi Condensed	regular
SofiaSans[wght]	Sofia Sans	regular
Solitreo-Regular	Solitreo	regular
Solway-Bold	Solway	bold
Solway-ExtraBold	Solway	extrabold
Solway-Light	Solway	light
Solway-Medium	Solway	medium
Solway-Regular	Solway	regular
SometypeMono-Italic[wght]	Sometype Mono	italic
SometypeMono[wght]	Sometype Mono	regular
SongMyung-Regular	Song Myung	regular
Sono[MONO,wght]	Sono	regular
SonsieOne-Regular	Sonsie One	regular
Sora[wght]	Sora	regular
SortsMillGoudy-Italic	Sorts Mill Goudy	italic
SortsMillGoudy-Regular	Sorts Mill Goudy	regular
Souliyo-Regular	NONE	regular
SourceCodePro-Italic[wght]	Source Code Pro	italic
SourceCodePro[wght]	Source Code Pro	regular
SourceSans3-Italic[wght]	Source Sans 3	italic
SourceSans3[wght]	Source Sans 3	regular
SourceSerif4-Italic[opsz,wght]	Source Serif 4	italic
SourceSerif4[opsz,wght]	Source Serif 4	regular
SpaceGrotesk[wght]	Space Grotesk	regular
SpaceMono-Bold	Space Mono	bold
SpaceMono-BoldItalic	Space Mono	bolditalic
SpaceMono-Italic	Space Mono	italic
SpaceMono-Regular	Space Mono	regular
SpecialElite-Regular	Special Elite	regular
Spectral-Bold	Spectral	bold
Spectral-BoldItalic	Spectral	bolditalic
Spectral-ExtraBold	Spectral	extrabold
Spectral-ExtraBoldItalic	Spectral	extrabolditalic
Spectral-ExtraLight	Spectral	extralight
Spectral-ExtraLightItalic	Spectral	extralightitalic
Spectral-Italic	Spectral	italic
Spectral-Light	Spectral	light
Spectral-LightItalic	Spectral	lightitalic
Spectral-Medium	Spectral	medium
Spectral-MediumItalic	Spectral	mediumitalic
Spectral-Regular	Spectral	regular
Spectral-SemiBold	Spectral	semibold
Spectral-SemiBoldItalic	Spectral	semibolditalic
SpectralSC-Bold	Spectral SC	bold
SpectralSC-BoldItalic	Spectral SC	bolditalic
SpectralSC-ExtraBold	Spectral SC	extrabold
SpectralSC-ExtraBoldItalic	Spectral SC	extrabolditalic
SpectralSC-ExtraLight	Spectral SC	extralight
SpectralSC-ExtraLightItalic	Spectral SC	extralightitalic
SpectralSC-Italic	Spectral SC	italic
SpectralSC-Light	Spectral SC	light
SpectralSC-LightItalic	Spectral SC	lightitalic
SpectralSC-Medium	Spectral SC	medium
SpectralSC-MediumItalic	Spectral SC	mediumitalic
SpectralSC-Regular	Spectral SC	regular
SpectralSC-SemiBold	Spectral SC	semibold
SpectralSC-SemiBoldItalic	Spectral SC	semibolditalic
SpicyRice-Regular	Spicy Rice	regular
Spinnaker-Regular	Spinnaker	regular
Spirax-Regular	Spirax	regular
Splash-Regular	Splash	regular
SplineSansMono-Italic[wght]	Spline Sans Mono	italic
SplineSansMono[wght]	Spline Sans Mono	regular
SplineSans[wght]	Spline Sans	regular
SquadaOne-Regular	Squada One	regular
SquarePeg-Regular	Square Peg	regular
SreeKrushnadevaraya-Regular	Sree Krushnadevaraya	regular
Sriracha-Regular	Sriracha	regular
Srisakdi-Bold	Srisakdi	bold
Srisakdi-Regular	Srisakdi	regular
Staatliches-Regular	Staatliches	regular
Stalemate-Regular	Stalemate	regular
StalinistOne-Regular	Stalinist One	regular
StardosStencil-Bold	Stardos Stencil	bold
StardosStencil-Regular	Stardos Stencil	regular
Stick-Regular	Stick	regular
StickNoBills[wght]	Stick No Bills	regular
StintUltraCondensed-Regular	Stint Ultra Condensed	regular
StintUltraExpanded-Regular	Stint Ultra Expanded	regular
Stoke-Light	Stoke	light
Stoke-Regular	Stoke	regular
Strait-Regular	Strait	regular
Strong-Regular	NONE	regular
StyleScript-Regular	Style Script	regular
Stylish-Regular	Stylish	regular
SueEllenFrancisco-Regular	Sue Ellen Francisco	regular
SuezOne-Regular	Suez One	regular
SulphurPoint-Bold	Sulphur Point	bold
SulphurPoint-Light	Sulphur Point	light
SulphurPoint-Regular	Sulphur Point	regular
Sumana-Bold	Sumana	bold
Sumana-Regular	Sumana	regular
Sunflower-Bold	Sunflower	bold
Sunflower-Light	Sunflower	light
Sunflower-Medium	Sunflower	medium
Sunshiney-Regular	Sunshiney	regular
SupermercadoOne-Regular	Supermercado One	regular
Sura-Bold	Sura	bold
Sura-Regular	Sura	regular
Suranna-Regular	Suranna	regular
Suravaram-Regular	Suravaram	regular
Suwannaphum-Black	Suwannaphum	black
Suwannaphum-Bold	Suwannaphum	bold
Suwannaphum-Light	Suwannaphum	light
Suwannaphum-Regular	Suwannaphum	regular
Suwannaphum-Thin	Suwannaphum	thin
SwankyandMooMoo	Swanky and Moo Moo	regular
Syncopate-Bold	Syncopate	bold
Syncopate-Regular	Syncopate	regular
SyneMono-Regular	Syne Mono	regular
SyneTactile-Regular	Syne Tactile	regular
Syne[wght]	Syne	regular
TaiHeritagePro-Bold	Tai Heritage Pro	bold
TaiHeritagePro-Regular	Tai Heritage Pro	regular
Tajawal-Black	Tajawal	black
Tajawal-Bold	Tajawal	bold
Tajawal-ExtraBold	Tajawal	extrabold
Tajawal-ExtraLight	Tajawal	extralight
Tajawal-Light	Tajawal	light
Tajawal-Medium	Tajawal	medium
Tajawal-Regular	Tajawal	regular
Tangerine-Bold	Tangerine	bold
Tangerine-Regular	Tangerine	regular
Tapestry-Regular	Tapestry	regular
Taprom-Regular	Taprom	regular
Tauri-Regular	Tauri	regular
Taviraj-Black	Taviraj	black
Taviraj-BlackItalic	Taviraj	blackitalic
Taviraj-Bold	Taviraj	bold
Taviraj-BoldItalic	Taviraj	bolditalic
Taviraj-ExtraBold	Taviraj	extrabold
Taviraj-ExtraBoldItalic	Taviraj	extrabolditalic
Taviraj-ExtraLight	Taviraj	extralight
Taviraj-ExtraLightItalic	Taviraj	extralightitalic
Taviraj-Italic	Taviraj	italic
Taviraj-Light	Taviraj	light
Taviraj-LightItalic	Taviraj	lightitalic
Taviraj-Medium	Taviraj	medium
Taviraj-MediumItalic	Taviraj	mediumitalic
Taviraj-Regular	Taviraj	regular
Taviraj-SemiBold	Taviraj	semibold
Taviraj-SemiBoldItalic	Taviraj	semibolditalic
Taviraj-Thin	Taviraj	thin
Taviraj-ThinItalic	Taviraj	thinitalic
Teko[wght]	Teko	regular
Tektur[wdth,wght]	Tektur	regular
Telex-Regular	Telex	regular
TenaliRamakrishna-Regular	Tenali Ramakrishna	regular
TenorSans-Regular	Tenor Sans	regular
TextMeOne-Regular	Text Me One	regular
Texturina-Italic[opsz,wght]	Texturina	italic
Texturina[opsz,wght]	Texturina	regular
Thabit-Bold	NONE	bold
Thabit-BoldOblique	NONE	boldoblique
Thabit-Oblique	NONE	oblique
Thabit	NONE	regular
Tharlon-Regular	NONE	regular
Thasadith-Bold	Thasadith	bold
Thasadith-BoldItalic	Thasadith	bolditalic
Thasadith-Italic	Thasadith	italic
Thasadith-Regular	Thasadith	regular
TheGirlNextDoor	The Girl Next Door	regular
TheNautigal-Bold	The Nautigal	bold
TheNautigal-Regular	The Nautigal	regular
Tienne-Black	Tienne	black
Tienne-Bold	Tienne	bold
Tienne-Regular	Tienne	regular
Tillana-Bold	Tillana	bold
Tillana-ExtraBold	Tillana	extrabold
Tillana-Medium	Tillana	medium
Tillana-Regular	Tillana	regular
Tillana-SemiBold	Tillana	semibold
TiltNeon[XROT,YROT]	Tilt Neon	regular
TiltPrism[XROT,YROT]	Tilt Prism	regular
TiltWarp[XROT,YROT]	Tilt Warp	regular
Times New Roman	NONE	regular
Timmana-Regular	Timmana	regular
Tinos-Bold	Tinos	bold
Tinos-BoldItalic	Tinos	bolditalic
Tinos-Italic	Tinos	italic
Tinos-Regular	Tinos	regular
TiroBangla-Italic	Tiro Bangla	italic
TiroBangla-Regular	Tiro Bangla	regular
TiroDevanagariHindi-Italic	Tiro Devanagari Hindi	italic
TiroDevanagariHindi-Regular	Tiro Devanagari Hindi	regular
TiroDevanagariMarathi-Italic	Tiro Devanagari Marathi	italic
TiroDevanagariMarathi-Regular	Tiro Devanagari Marathi	regular
TiroDevanagariSanskrit-Italic	Tiro Devanagari Sanskrit	italic
TiroDevanagariSanskrit-Regular	Tiro Devanagari Sanskrit	regular
TiroGurmukhi-Italic	Tiro Gurmukhi	italic
TiroGurmukhi-Regular	Tiro Gurmukhi	regular
TiroKannada-Italic	Tiro Kannada	italic
TiroKannada-Regular	Tiro Kannada	regular
TiroTamil-Italic	Tiro Tamil	italic
TiroTamil-Regular	Tiro Tamil	regular
TiroTelugu-Italic	Tiro Telugu	italic
TiroTelugu-Regular	Tiro Telugu	regular
TitanOne-Regular	Titan One	regular
TitilliumWeb-Black	Titillium Web	black
TitilliumWeb-Bold	Titillium Web	bold
TitilliumWeb-BoldItalic	Titillium Web	bolditalic
TitilliumWeb-ExtraLight	Titillium Web	extralight
TitilliumWeb-ExtraLightItalic	Titillium Web	extralightitalic
TitilliumWeb-Italic	Titillium Web	italic
TitilliumWeb-Light	Titillium Web	light
TitilliumWeb-LightItalic	Titillium Web	lightitalic
TitilliumWeb-Regular	Titillium Web	regular
TitilliumWeb-SemiBold	Titillium Web	semibold
TitilliumWeb-SemiBoldItalic	Titillium Web	semibolditalic
Tomorrow-Black	Tomorrow	black
Tomorrow-BlackItalic	Tomorrow	blackitalic
Tomorrow-Bold	Tomorrow	bold
Tomorrow-BoldItalic	Tomorrow	bolditalic
Tomorrow-ExtraBold	Tomorrow	extrabold
Tomorrow-ExtraBoldItalic	Tomorrow	extrabolditalic
Tomorrow-ExtraLight	Tomorrow	extralight
Tomorrow-ExtraLightItalic	Tomorrow	extralightitalic
Tomorrow-Italic	Tomorrow	italic
Tomorrow-Light	Tomorrow	light
Tomorrow-LightItalic	Tomorrow	lightitalic
Tomorrow-Medium	Tomorrow	medium
Tomorrow-MediumItalic	Tomorrow	mediumitalic
Tomorrow-Regular	Tomorrow	regular
Tomorrow-SemiBold	Tomorrow	semibold
Tomorrow-SemiBoldItalic	Tomorrow	semibolditalic
Tomorrow-Thin	Tomorrow	thin
Tomorrow-ThinItalic	Tomorrow	thinitalic
Tourney-Italic[wdth,wght]	Tourney	italic
Tourney[wdth,wght]	Tourney	regular
TradeWinds-Regular	Trade Winds	regular
TrainOne-Regular	Train One	regular
Trebuchet MS	NONE	regular
Trirong-Black	Trirong	black
Trirong-BlackItalic	Trirong	blackitalic
Trirong-Bold	Trirong	bold
Trirong-BoldItalic	Trirong	bolditalic
Trirong-ExtraBold	Trirong	extrabold
Trirong-ExtraBoldItalic	Trirong	extrabolditalic
Trirong-ExtraLight	Trirong	extralight
Trirong-ExtraLightItalic	Trirong	extralightitalic
Trirong-Italic	Trirong	italic
Trirong-Light	Trirong	light
Trirong-LightItalic	Trirong	lightitalic
Trirong-Medium	Trirong	medium
Trirong-MediumItalic	Trirong	mediumitalic
Trirong-Regular	Trirong	regular
Trirong-SemiBold	Trirong	semibold
Trirong-SemiBoldItalic	Trirong	semibolditalic
Trirong-Thin	Trirong	thin
Trirong-ThinItalic	Trirong	thinitalic
Trispace[wdth,wght]	Trispace	regular
Trocchi-Regular	Trocchi	regular
Trochut-Bold	Trochut	bold
Trochut-Italic	Trochut	italic
Trochut-Regular	Trochut	regular
Truculenta[opsz,wdth,wght]	Truculenta	regular
Trykker-Regular	Trykker	regular
TsukimiRounded-Bold	Tsukimi Rounded	bold
TsukimiRounded-Light	Tsukimi Rounded	light
TsukimiRounded-Medium	Tsukimi Rounded	medium
TsukimiRounded-Regular	Tsukimi Rounded	regular
TsukimiRounded-SemiBold	Tsukimi Rounded	semibold
Tuffy-Bold	NONE	bold
Tuffy-BoldItalic	NONE	bolditalic
Tuffy-Italic	NONE	italic
Tuffy-Regular	NONE	regular
TulpenOne-Regular	Tulpen One	regular
TurretRoad-Bold	Turret Road	bold
TurretRoad-ExtraBold	Turret Road	extrabold
TurretRoad-ExtraLight	Turret Road	extralight
TurretRoad-Light	Turret Road	light
TurretRoad-Medium	Turret Road	medium
TurretRoad-Regular	Turret Road	regular
TwinkleStar-Regular	Twinkle Star	regular
Uchen-Regular	Uchen	regular
Ultra-Regular	Ultra	regular
Unbounded[wght]	Unbounded	regular
UncialAntiqua-Regular	Uncial Antiqua	regular
Underdog-Regular	Underdog	regular
UnicaOne-Regular	Unica One	regular
UnifrakturCook-Bold	UnifrakturCook	bold
UnifrakturMaguntia-Book	UnifrakturMaguntia	regular
Unkempt-Bold	Unkempt	bold
Unkempt-Regular	Unkempt	regular
Unlock-Regular	Unlock	regular
Unna-Bold	Unna	bold
Unna-BoldItalic	Unna	bolditalic
Unna-Italic	Unna	italic
Unna-Regular	Unna	regular
Updock-Regular	Updock	regular
Urbanist-Italic[wght]	Urbanist	italic
Urbanist[wght]	Urbanist	regular
VT323-Regular	VT323	regular
VampiroOne-Regular	Vampiro One	regular
Varela-Regular	Varela	regular
VarelaRound-Regular	Varela Round	regular
Varta[wght]	Varta	regular
VastShadow-Regular	Vast Shadow	regular
Vazirmatn[wght]	Vazirmatn	regular
VesperLibre-Bold	Vesper Libre	bold
VesperLibre-Heavy	Vesper Libre	heavy
VesperLibre-Medium	Vesper Libre	medium
VesperLibre-Regular	Vesper Libre	regular
ViaodaLibre-Regular	Viaoda Libre	regular
Vibes-Regular	Vibes	regular
Vibur-Regular	Vibur	regular
VictorMono-Italic[wght]	Victor Mono	italic
VictorMono[wght]	Victor Mono	regular
Vidaloka-Regular	Vidaloka	regular
Viga-Regular	Viga	regular
VinaSans-Regular	Vina Sans	regular
Voces-Regular	Voces	regular
Volkhov-Bold	Volkhov	bold
Volkhov-BoldItalic	Volkhov	bolditalic
Volkhov-Italic	Volkhov	italic
Volkhov-Regular	Volkhov	regular
Vollkorn-Italic[wght]	Vollkorn	italic
VollkornSC-Black	Vollkorn SC	black
VollkornSC-Bold	Vollkorn SC	bold
VollkornSC-Regular	Vollkorn SC	regular
VollkornSC-SemiBold	Vollkorn SC	semibold
Vollkorn[wght]	Vollkorn	regular
Voltaire-Regular	Voltaire	regular
VujahdayScript-Regular	Vujahday Script	regular
WaitingfortheSunrise	Waiting for the Sunrise	regular
Wallpoet-Regular	Wallpoet	regular
WalterTurncoat-Regular	Walter Turncoat	regular
Warnes-Regular	Warnes	regular
WaterBrush-Regular	Water Brush	regular
Waterfall-Regular	Waterfall	regular
Wavefont[ROND,YELA,wght]	Wavefont	regular
Wellfleet-Regular	Wellfleet	regular
WendyOne-Regular	Wendy One	regular
Whisper-Regular	Whisper	regular
WindSong-Medium	WindSong	medium
WindSong-Regular	WindSong	regular
WireOne-Regular	Wire One	regular
WixMadeforDisplay[wght]	Wix Madefor Display	regular
WixMadeforText-Bold	Wix Madefor Text	bold
WixMadeforText-BoldItalic	Wix Madefor Text	bolditalic
WixMadeforText-ExtraBold	Wix Madefor Text	extrabold
WixMadeforText-ExtraBoldItalic	Wix Madefor Text	extrabolditalic
WixMadeforText-Italic	Wix Madefor Text	italic
WixMadeforText-Italic[wght]	Wix Madefor Text	italic
WixMadeforText-Medium	Wix Madefor Text	medium
WixMadeforText-MediumItalic	Wix Madefor Text	mediumitalic
WixMadeforText-Regular	Wix Madefor Text	regular
WixMadeforText-SemiBold	Wix Madefor Text	semibold
WixMadeforText-SemiBoldItalic	Wix Madefor Text	semibolditalic
WixMadeforText[wght]	Wix Madefor Text	regular
WorkSans-Italic[wght]	Work Sans	italic
WorkSans[wght]	Work Sans	regular
Workbench[BLED,SCAN]	Workbench	regular
XanhMono-Italic	Xanh Mono	italic
XanhMono-Regular	Xanh Mono	regular
YaldeviColombo-Bold	Yaldevi	bold
YaldeviColombo-ExtraLight	Yaldevi	extralight
YaldeviColombo-Light	Yaldevi	light
YaldeviColombo-Medium	Yaldevi	medium
YaldeviColombo-Regular	Yaldevi	regular
YaldeviColombo-SemiBold	Yaldevi	semibold
Yaldevi[wght]	Yaldevi	regular
YanoneKaffeesatz[wght]	Yanone Kaffeesatz	regular
Yantramanav-Black	Yantramanav	black
Yantramanav-Bold	Yantramanav	bold
Yantramanav-Light	Yantramanav	light
Yantramanav-Medium	Yantramanav	medium
Yantramanav-Regular	Yantramanav	regular
Yantramanav-Thin	Yantramanav	thin
YatraOne-Regular	Yatra One	regular
Yellowtail-Regular	Yellowtail	regular
YeonSung-Regular	Yeon Sung	regular
YesevaOne-Regular	Yeseva One	regular
Yesteryear-Regular	Yesteryear	regular
Yinmar-Regular	NONE	regular
Yomogi-Regular	Yomogi	regular
YoungSerif-Regular	Young Serif	regular
Yrsa-Italic[wght]	Yrsa	italic
Yrsa[wght]	Yrsa	regular
Ysabeau-Italic[wght]	Ysabeau	italic
YsabeauInfant-Italic[wght]	Ysabeau Infant	italic
YsabeauInfant[wght]	Ysabeau Infant	regular
YsabeauOffice-Italic[wght]	Ysabeau Office	italic
YsabeauOffice[wght]	Ysabeau Office	regular
YsabeauSC[wght]	Ysabeau SC	regular
Ysabeau[wght]	Ysabeau	regular
YujiBoku-Regular	Yuji Boku	regular
YujiHentaiganaAkari-Regular	Yuji Hentaigana Akari	regular
YujiHentaiganaAkebono-Regular	Yuji Hentaigana Akebono	regular
YujiMai-Regular	Yuji Mai	regular
YujiSyuku-Regular	Yuji Syuku	regular
YuseiMagic-Regular	Yusei Magic	regular
ZCOOLKuaiLe-Regular	ZCOOL KuaiLe	regular
ZCOOLQingKeHuangYou-Regular	ZCOOL QingKe HuangYou	regular
ZCOOLXiaoWei-Regular	ZCOOL XiaoWei	regular
ZenAntique-Regular	Zen Antique	regular
ZenAntiqueSoft-Regular	Zen Antique Soft	regular
ZenDots-Regular	Zen Dots	regular
ZenKakuGothicAntique-Black	Zen Kaku Gothic Antique	black
ZenKakuGothicAntique-Bold	Zen Kaku Gothic Antique	bold
ZenKakuGothicAntique-Light	Zen Kaku Gothic Antique	light
ZenKakuGothicAntique-Medium	Zen Kaku Gothic Antique	medium
ZenKakuGothicAntique-Regular	Zen Kaku Gothic Antique	regular
ZenKakuGothicNew-Black	Zen Kaku Gothic New	black
ZenKakuGothicNew-Bold	Zen Kaku Gothic New	bold
ZenKakuGothicNew-Light	Zen Kaku Gothic New	light
ZenKakuGothicNew-Medium	Zen Kaku Gothic New	medium
ZenKakuGothicNew-Regular	Zen Kaku Gothic New	regular
ZenKurenaido-Regular	Zen Kurenaido	regular
ZenLoop-Italic	Zen Loop	italic
ZenLoop-Regular	Zen Loop	regular
ZenMaruGothic-Black	Zen Maru Gothic	black
ZenMaruGothic-Bold	Zen Maru Gothic	bold
ZenMaruGothic-Light	Zen Maru Gothic	light
ZenMaruGothic-Medium	Zen Maru Gothic	medium
ZenMaruGothic-Regular	Zen Maru Gothic	regular
ZenOldMincho-Black	Zen Old Mincho	black
ZenOldMincho-Bold	Zen Old Mincho	bold
ZenOldMincho-Medium	Zen Old Mincho	medium
ZenOldMincho-Regular	Zen Old Mincho	regular
ZenOldMincho-SemiBold	Zen Old Mincho	semibold
ZenTokyoZoo-Regular	Zen Tokyo Zoo	regular
Zeyada	Zeyada	regular
ZhiMangXing-Regular	Zhi Mang Xing	regular
ZillaSlab-Bold	Zilla Slab	bold
ZillaSlab-BoldItalic	Zilla Slab	bolditalic
ZillaSlab-Italic	Zilla Slab	italic
ZillaSlab-Light	Zilla Slab	light
ZillaSlab-LightItalic	Zilla Slab	lightitalic
ZillaSlab-Medium	Zilla Slab	medium
ZillaSlab-MediumItalic	Zilla Slab	mediumitalic
ZillaSlab-Regular	Zilla Slab	regular
ZillaSlab-SemiBold	Zilla Slab	semibold
ZillaSlab-SemiBoldItalic	Zilla Slab	semibolditalic
ZillaSlabHighlight-Bold	Zilla Slab Highlight	bold
ZillaSlabHighlight-Regular	Zilla Slab Highlight	regular
jsMath-cmbx10	NONE	NONE
jsMath-cmex10	NONE	NONE
jsMath-cmmi10	NONE	NONE
jsMath-cmr10	NONE	NONE
jsMath-cmsy10	NONE	NONE
jsMath-cmti10	NONE	NONE